Hand ID: 2

PokerStars Zoom Hand #250961217484:  Hold'em No Limit ($0.01/$0.02) - 2024/06/10 19:21:02 ET
Table 'Halley' 6-max Seat #1 is the button
Seat 1: pedro064 ($0.48 in chips)
Seat 2: HumptyD ($2 in chips)
Seat 3: bflorenciano ($2.31 in chips)
Seat 4: JMassensini ($2.25 in chips)
Seat 5: brunoafrao ($1.14 in chips)
Seat 6: Tio Jhonas ($1.07 in chips)
HumptyD: posts small blind $0.01
bflorenciano: posts big blind $0.02
*** HOLE CARDS ***
Dealt to HumptyD [5c Qh]
JMassensini: folds
brunoafrao: folds
Tio Jhonas: folds
pedro064: folds
HumptyD: calls $0.01
bflorenciano: raises $0.08 to $0.10
HumptyD: folds
Uncalled bet ($0.08) returned to bflorenciano
bflorenciano collected $0.04 from pot
bflorenciano: doesn't show hand
*** SUMMARY ***
Total pot $0.04 | Rake $0
Seat 1: pedro064 (button) folded before Flop (didn't bet)
Seat 2: HumptyD (small blind) folded before Flop
Seat 3: bflorenciano (big blind) collected ($0.04)
Seat 4: JMassensini folded before Flop (didn't bet)
Seat 5: brunoafrao folded before Flop (didn't bet)
Seat 6: Tio Jhonas folded before Flop (didn't bet)

PokerStars Zoom Hand #250961214648:  Hold'em No Limit ($0.01/$0.02) - 2024/06/10 19:20:49 ET
Table 'Halley' 6-max Seat #1 is the button
Seat 1: gra44fun ($2.12 in chips)
Seat 2: BaStEr001213 ($1.07 in chips)
Seat 3: HumptyD ($2 in chips)
Seat 4: alenastorm ($0.45 in chips)
Seat 5: WB_SOH ($2.70 in chips)
Seat 6: ElFruna ($1.87 in chips)
BaStEr001213: posts small blind $0.01
HumptyD: posts big blind $0.02
*** HOLE CARDS ***
Dealt to HumptyD [2s 9s]
alenastorm: raises $0.04 to $0.06
WB_SOH: raises $0.11 to $0.17
ElFruna: folds
gra44fun: folds
BaStEr001213: folds
HumptyD: folds
alenastorm: calls $0.11
*** FLOP *** [Jh 6d 8s]
alenastorm: checks
WB_SOH: bets $0.21
alenastorm: raises $0.07 to $0.28 and is all-in
WB_SOH: calls $0.07
*** TURN *** [Jh 6d 8s] [3d]
*** RIVER *** [Jh 6d 8s 3d] [Ad]
*** SHOW DOWN ***
alenastorm: shows [8d 8h] (three of a kind, Eights)
WB_SOH: shows [Qh Qc] (a pair of Queens)
alenastorm cashed out the hand for $0.79 | Cash Out Fee $0.02
*** SUMMARY ***
Total pot $0.93 | Rake $0.03
Board [Jh 6d 8s 3d Ad]
Seat 1: gra44fun (button) folded before Flop (didn't bet)
Seat 2: BaStEr001213 (small blind) folded before Flop
Seat 3: HumptyD (big blind) folded before Flop
Seat 4: alenastorm showed [8d 8h] and won ($0.90) with three of a kind, Eights (pot not awarded as player cashed out)
Seat 5: WB_SOH showed [Qh Qc] and lost with a pair of Queens
Seat 6: ElFruna folded before Flop (didn't bet)

PokerStars Zoom Hand #250961224809:  Hold'em No Limit ($0.01/$0.02) - 2024/06/10 19:21:35 ET
Table 'Halley' 6-max Seat #1 is the button
Seat 1: HumptyD ($2 in chips)
Seat 2: Matzet1ka ($2 in chips)
Seat 3: gary01407 ($2.22 in chips)
Seat 4: slidepop ($2.83 in chips)
Seat 5: coolDadJimbo ($6.87 in chips)
Seat 6: maldobex ($1.81 in chips)
Matzet1ka: posts small blind $0.01
gary01407: posts big blind $0.02
*** HOLE CARDS ***
Dealt to HumptyD [6c 4d]
slidepop: folds
coolDadJimbo: folds
maldobex: raises $0.04 to $0.06
HumptyD: folds
Matzet1ka: folds
gary01407: folds
Uncalled bet ($0.04) returned to maldobex
maldobex collected $0.05 from pot
maldobex: doesn't show hand
*** SUMMARY ***
Total pot $0.05 | Rake $0
Seat 1: HumptyD (button) folded before Flop (didn't bet)
Seat 2: Matzet1ka (small blind) folded before Flop
Seat 3: gary01407 (big blind) folded before Flop
Seat 4: slidepop folded before Flop (didn't bet)
Seat 5: coolDadJimbo folded before Flop (didn't bet)
Seat 6: maldobex collected ($0.05)

PokerStars Zoom Hand #250961226365:  Hold'em No Limit ($0.01/$0.02) - 2024/06/10 19:21:42 ET
Table 'Halley' 6-max Seat #1 is the button
Seat 1: ripbon ($2.13 in chips)
Seat 2: praznina ($3.57 in chips)
Seat 3: HumptyD ($2 in chips)
Seat 4: TamiSieche ($4.27 in chips)
Seat 5: Mirajit ($2 in chips)
Seat 6: lewisweight ($2.01 in chips)
praznina: posts small blind $0.01
HumptyD: posts big blind $0.02
*** HOLE CARDS ***
Dealt to HumptyD [3s 4s]
TamiSieche: raises $0.05 to $0.07
Mirajit: folds
lewisweight: raises $0.13 to $0.20
ripbon: folds
praznina: folds
HumptyD: folds
TamiSieche: folds
Uncalled bet ($0.13) returned to lewisweight
lewisweight collected $0.17 from pot
lewisweight: doesn't show hand
*** SUMMARY ***
Total pot $0.17 | Rake $0
Seat 1: ripbon (button) folded before Flop (didn't bet)
Seat 2: praznina (small blind) folded before Flop
Seat 3: HumptyD (big blind) folded before Flop
Seat 4: TamiSieche folded before Flop
Seat 5: Mirajit folded before Flop (didn't bet)
Seat 6: lewisweight collected ($0.17)

PokerStars Zoom Hand #250961235286:  Hold'em No Limit ($0.01/$0.02) - 2024/06/10 19:22:22 ET
Table 'Halley' 6-max Seat #1 is the button
Seat 1: inthegreenz369 ($1.64 in chips)
Seat 2: aricast19 ($2.28 in chips)
Seat 3: Aleksis Audio ($2.30 in chips)
Seat 4: M4DM4X_FR ($2.12 in chips)
Seat 5: HumptyD ($2 in chips)
Seat 6: Invron11 ($2.01 in chips)
aricast19: posts small blind $0.01
Aleksis Audio: posts big blind $0.02
*** HOLE CARDS ***
Dealt to HumptyD [9d 7d]
M4DM4X_FR: folds
HumptyD: folds
Invron11: folds
inthegreenz369: raises $0.03 to $0.05
aricast19: folds
Aleksis Audio: folds
Uncalled bet ($0.03) returned to inthegreenz369
inthegreenz369 collected $0.05 from pot
inthegreenz369: doesn't show hand
*** SUMMARY ***
Total pot $0.05 | Rake $0
Seat 1: inthegreenz369 (button) collected ($0.05)
Seat 2: aricast19 (small blind) folded before Flop
Seat 3: Aleksis Audio (big blind) folded before Flop
Seat 4: M4DM4X_FR folded before Flop (didn't bet)
Seat 5: HumptyD folded before Flop (didn't bet)
Seat 6: Invron11 folded before Flop (didn't bet)

PokerStars Zoom Hand #250961237340:  Hold'em No Limit ($0.01/$0.02) - 2024/06/10 19:22:31 ET
Table 'Halley' 6-max Seat #1 is the button
Seat 1: DYAR17 ($1.32 in chips)
Seat 2: HumptyD ($2 in chips)
Seat 3: Luciano V609 ($4.53 in chips)
Seat 4: argent55 ($3.39 in chips)
Seat 5: hibyz ($3.08 in chips)
Seat 6: mr_maxsize ($4.19 in chips)
HumptyD: posts small blind $0.01
Luciano V609: posts big blind $0.02
*** HOLE CARDS ***
Dealt to HumptyD [3s 5s]
argent55: folds
hibyz: folds
mr_maxsize: folds
DYAR17: folds
HumptyD: folds
Uncalled bet ($0.01) returned to Luciano V609
Luciano V609 collected $0.02 from pot
Luciano V609: doesn't show hand
*** SUMMARY ***
Total pot $0.02 | Rake $0
Seat 1: DYAR17 (button) folded before Flop (didn't bet)
Seat 2: HumptyD (small blind) folded before Flop
Seat 3: Luciano V609 (big blind) collected ($0.02)
Seat 4: argent55 folded before Flop (didn't bet)
Seat 5: hibyz folded before Flop (didn't bet)
Seat 6: mr_maxsize folded before Flop (didn't bet)

PokerStars Zoom Hand #250961240896:  Hold'em No Limit ($0.01/$0.02) - 2024/06/10 19:22:47 ET
Table 'Halley' 6-max Seat #1 is the button
Seat 1: Karlrotte ($1.31 in chips)
Seat 2: HECTOR1500 ($2 in chips)
Seat 3: bord258 ($1.68 in chips)
Seat 4: HumptyD ($2 in chips)
Seat 5: bryld2 ($2.47 in chips)
Seat 6: WhiteDeath55 ($2 in chips)
HECTOR1500: posts small blind $0.01
bord258: posts big blind $0.02
*** HOLE CARDS ***
Dealt to HumptyD [8h 7s]
HumptyD: folds
bryld2: folds
WhiteDeath55: folds
Karlrotte: folds
HECTOR1500: raises $0.04 to $0.06
bord258: folds
Uncalled bet ($0.04) returned to HECTOR1500
HECTOR1500 collected $0.04 from pot
HECTOR1500: doesn't show hand
*** SUMMARY ***
Total pot $0.04 | Rake $0
Seat 1: Karlrotte (button) folded before Flop (didn't bet)
Seat 2: HECTOR1500 (small blind) collected ($0.04)
Seat 3: bord258 (big blind) folded before Flop
Seat 4: HumptyD folded before Flop (didn't bet)
Seat 5: bryld2 folded before Flop (didn't bet)
Seat 6: WhiteDeath55 folded before Flop (didn't bet)

PokerStars Zoom Hand #250961231071:  Hold'em No Limit ($0.01/$0.02) - 2024/06/10 19:22:03 ET
Table 'Halley' 6-max Seat #1 is the button
Seat 1: 15Thousand ($1.12 in chips)
Seat 2: Snakeflight ($7.55 in chips)
Seat 3: ildivodeoro ($1.66 in chips)
Seat 4: Mirajit ($5.66 in chips)
Seat 5: gra44fun ($2.64 in chips)
Seat 6: HumptyD ($2 in chips)
Snakeflight: posts small blind $0.01
ildivodeoro: posts big blind $0.02
*** HOLE CARDS ***
Dealt to HumptyD [Tc Jh]
Mirajit: folds
gra44fun: folds
HumptyD: folds
15Thousand: calls $0.02
Snakeflight: calls $0.01
ildivodeoro: checks
*** FLOP *** [3d 5d 8d]
Snakeflight: bets $0.03
ildivodeoro: calls $0.03
15Thousand: folds
*** TURN *** [3d 5d 8d] [Qh]
Snakeflight: bets $0.12
ildivodeoro: folds
Uncalled bet ($0.12) returned to Snakeflight
Snakeflight collected $0.12 from pot
Snakeflight: doesn't show hand
*** SUMMARY ***
Total pot $0.12 | Rake $0
Board [3d 5d 8d Qh]
Seat 1: 15Thousand (button) folded on the Flop
Seat 2: Snakeflight (small blind) collected ($0.12)
Seat 3: ildivodeoro (big blind) folded on the Turn
Seat 4: Mirajit folded before Flop (didn't bet)
Seat 5: gra44fun folded before Flop (didn't bet)
Seat 6: HumptyD folded before Flop (didn't bet)

PokerStars Zoom Hand #250961242940:  Hold'em No Limit ($0.01/$0.02) - 2024/06/10 19:22:56 ET
Table 'Halley' 6-max Seat #1 is the button
Seat 1: mr_maxsize ($4.19 in chips)
Seat 2: bettanye ($2.08 in chips)
Seat 3: Invron11 ($3.18 in chips)
Seat 4: HumptyD ($2 in chips)
Seat 5: praznina ($3.01 in chips)
Seat 6: Mirajit ($2 in chips)
bettanye: posts small blind $0.01
Invron11: posts big blind $0.02
*** HOLE CARDS ***
Dealt to HumptyD [6c Js]
HumptyD: folds
praznina: folds
Mirajit: folds
mr_maxsize: folds
bettanye: folds
Uncalled bet ($0.01) returned to Invron11
Invron11 collected $0.02 from pot
Invron11: doesn't show hand
*** SUMMARY ***
Total pot $0.02 | Rake $0
Seat 1: mr_maxsize (button) folded before Flop (didn't bet)
Seat 2: bettanye (small blind) folded before Flop
Seat 3: Invron11 (big blind) collected ($0.02)
Seat 4: HumptyD folded before Flop (didn't bet)
Seat 5: praznina folded before Flop (didn't bet)
Seat 6: Mirajit folded before Flop (didn't bet)

PokerStars Zoom Hand #250961241824:  Hold'em No Limit ($0.01/$0.02) - 2024/06/10 19:22:51 ET
Table 'Halley' 6-max Seat #1 is the button
Seat 1: HumptyD ($2 in chips)
Seat 2: Karlrotte ($1.31 in chips)
Seat 3: BaStEr001213 ($1.43 in chips)
Seat 4: schievelbein ($2.84 in chips)
Seat 5: RafaByPoker ($2.63 in chips)
Seat 6: AndreGlehn ($1.58 in chips)
Karlrotte: posts small blind $0.01
BaStEr001213: posts big blind $0.02
*** HOLE CARDS ***
Dealt to HumptyD [Qh 8h]
schievelbein: folds
RafaByPoker: folds
AndreGlehn: calls $0.02
HumptyD: folds
Karlrotte: calls $0.01
BaStEr001213: checks
*** FLOP *** [Qd Kh 3c]
Karlrotte: checks
BaStEr001213: checks
AndreGlehn: checks
*** TURN *** [Qd Kh 3c] [6c]
Karlrotte: checks
BaStEr001213: checks
AndreGlehn: bets $0.02
Karlrotte: calls $0.02
BaStEr001213: folds
*** RIVER *** [Qd Kh 3c 6c] [3d]
Karlrotte: bets $0.06
AndreGlehn: folds
Uncalled bet ($0.06) returned to Karlrotte
Karlrotte collected $0.10 from pot
Karlrotte: doesn't show hand
*** SUMMARY ***
Total pot $0.10 | Rake $0
Board [Qd Kh 3c 6c 3d]
Seat 1: HumptyD (button) folded before Flop (didn't bet)
Seat 2: Karlrotte (small blind) collected ($0.10)
Seat 3: BaStEr001213 (big blind) folded on the Turn
Seat 4: schievelbein folded before Flop (didn't bet)
Seat 5: RafaByPoker folded before Flop (didn't bet)
Seat 6: AndreGlehn folded on the River

PokerStars Zoom Hand #250961246566:  Hold'em No Limit ($0.01/$0.02) - 2024/06/10 19:23:12 ET
Table 'Halley' 6-max Seat #1 is the button
Seat 1: brunoafrao ($1.11 in chips)
Seat 2: hibyz ($3.05 in chips)
Seat 3: Quantum771 ($2 in chips)
Seat 4: Shakalas248 ($4.20 in chips)
Seat 5: strashilisht ($2.24 in chips)
Seat 6: HumptyD ($2 in chips)
hibyz: posts small blind $0.01
Quantum771: posts big blind $0.02
*** HOLE CARDS ***
Dealt to HumptyD [2c Ac]
Shakalas248: folds
strashilisht: folds
HumptyD: raises $0.04 to $0.06
brunoafrao: folds
hibyz: calls $0.05
Quantum771: calls $0.04
*** FLOP *** [6d 4h 8h]
hibyz: bets $0.09
Quantum771: folds
HumptyD: folds
Uncalled bet ($0.09) returned to hibyz
hibyz collected $0.17 from pot
hibyz: doesn't show hand
*** SUMMARY ***
Total pot $0.18 | Rake $0.01
Board [6d 4h 8h]
Seat 1: brunoafrao (button) folded before Flop (didn't bet)
Seat 2: hibyz (small blind) collected ($0.17)
Seat 3: Quantum771 (big blind) folded on the Flop
Seat 4: Shakalas248 folded before Flop (didn't bet)
Seat 5: strashilisht folded before Flop (didn't bet)
Seat 6: HumptyD folded on the Flop

PokerStars Zoom Hand #250961257541:  Hold'em No Limit ($0.01/$0.02) - 2024/06/10 19:24:01 ET
Table 'Halley' 6-max Seat #1 is the button
Seat 1: brunoafrao ($1.08 in chips)
Seat 2: -analisante- ($3.29 in chips)
Seat 3: HumptyD ($2 in chips)
Seat 4: ramirodl'b ($2.18 in chips)
Seat 5: mr_maxsize ($3.57 in chips)
Seat 6: Razhorus ($1.64 in chips)
-analisante-: posts small blind $0.01
HumptyD: posts big blind $0.02
*** HOLE CARDS ***
Dealt to HumptyD [9h 6c]
ramirodl'b: folds
mr_maxsize: raises $0.03 to $0.05
Razhorus: calls $0.05
brunoafrao: folds
-analisante-: folds
HumptyD: folds
*** FLOP *** [4c Qd 8s]
mr_maxsize: bets $0.10
Razhorus: folds
Uncalled bet ($0.10) returned to mr_maxsize
mr_maxsize collected $0.13 from pot
mr_maxsize: doesn't show hand
*** SUMMARY ***
Total pot $0.13 | Rake $0
Board [4c Qd 8s]
Seat 1: brunoafrao (button) folded before Flop (didn't bet)
Seat 2: -analisante- (small blind) folded before Flop
Seat 3: HumptyD (big blind) folded before Flop
Seat 4: ramirodl'b folded before Flop (didn't bet)
Seat 5: mr_maxsize collected ($0.13)
Seat 6: Razhorus folded on the Flop

PokerStars Zoom Hand #250961259722:  Hold'em No Limit ($0.01/$0.02) - 2024/06/10 19:24:11 ET
Table 'Halley' 6-max Seat #1 is the button
Seat 1: HumptyD ($2 in chips)
Seat 2: gary01407 ($5.20 in chips)
Seat 3: maykolpb ($1.10 in chips)
Seat 4: bflorenciano ($3.36 in chips)
Seat 5: Quantum771 ($2.40 in chips)
Seat 6: alsec93 ($6.31 in chips)
gary01407: posts small blind $0.01
maykolpb: posts big blind $0.02
*** HOLE CARDS ***
Dealt to HumptyD [4s 3h]
bflorenciano: folds
Quantum771: folds
alsec93: raises $0.04 to $0.06
HumptyD: folds
gary01407: folds
maykolpb: folds
Uncalled bet ($0.04) returned to alsec93
alsec93 collected $0.05 from pot
alsec93: doesn't show hand
*** SUMMARY ***
Total pot $0.05 | Rake $0
Seat 1: HumptyD (button) folded before Flop (didn't bet)
Seat 2: gary01407 (small blind) folded before Flop
Seat 3: maykolpb (big blind) folded before Flop
Seat 4: bflorenciano folded before Flop (didn't bet)
Seat 5: Quantum771 folded before Flop (didn't bet)
Seat 6: alsec93 collected ($0.05)

PokerStars Zoom Hand #250961261519:  Hold'em No Limit ($0.01/$0.02) - 2024/06/10 19:24:19 ET
Table 'Halley' 6-max Seat #1 is the button
Seat 1: kremator29 ($3.42 in chips)
Seat 2: xxcuentaxx70 ($1.09 in chips)
Seat 3: P.Escobarrrr ($2 in chips)
Seat 4: Matzet1ka ($2 in chips)
Seat 5: HumptyD ($2 in chips)
Seat 6: Sotosnc750x ($4.02 in chips)
xxcuentaxx70: posts small blind $0.01
P.Escobarrrr: posts big blind $0.02
*** HOLE CARDS ***
Dealt to HumptyD [2c 5s]
Matzet1ka: folds
HumptyD: folds
Sotosnc750x: calls $0.02
kremator29: folds
xxcuentaxx70: folds
P.Escobarrrr: checks
*** FLOP *** [Qd 3s Th]
P.Escobarrrr: checks
Sotosnc750x: checks
*** TURN *** [Qd 3s Th] [5c]
P.Escobarrrr: bets $0.03
Sotosnc750x: folds
Uncalled bet ($0.03) returned to P.Escobarrrr
P.Escobarrrr collected $0.05 from pot
P.Escobarrrr: doesn't show hand
*** SUMMARY ***
Total pot $0.05 | Rake $0
Board [Qd 3s Th 5c]
Seat 1: kremator29 (button) folded before Flop (didn't bet)
Seat 2: xxcuentaxx70 (small blind) folded before Flop
Seat 3: P.Escobarrrr (big blind) collected ($0.05)
Seat 4: Matzet1ka folded before Flop (didn't bet)
Seat 5: HumptyD folded before Flop (didn't bet)
Seat 6: Sotosnc750x folded on the Turn

PokerStars Zoom Hand #250961263046:  Hold'em No Limit ($0.01/$0.02) - 2024/06/10 19:24:26 ET
Table 'Halley' 6-max Seat #1 is the button
Seat 1: matheus f 97 ($2.11 in chips)
Seat 2: HumptyD ($2 in chips)
Seat 3: Quantum771 ($2 in chips)
Seat 4: argent55 ($2.03 in chips)
Seat 5: Mr_Supp31 ($1.51 in chips)
Seat 6: lamosca51 ($3.05 in chips)
HumptyD: posts small blind $0.01
Quantum771: posts big blind $0.02
*** HOLE CARDS ***
Dealt to HumptyD [As 5s]
argent55: folds
Mr_Supp31: folds
lamosca51: folds
matheus f 97: raises $0.04 to $0.06
HumptyD: raises $0.14 to $0.20
Quantum771: raises $0.27 to $0.47
matheus f 97: folds
HumptyD: calls $0.27
*** FLOP *** [Td Kc 6s]
HumptyD: checks
Quantum771: checks
*** TURN *** [Td Kc 6s] [9h]
HumptyD: checks
Quantum771: bets $0.10
HumptyD: calls $0.10
*** RIVER *** [Td Kc 6s 9h] [3h]
HumptyD: checks
Quantum771: checks
*** SHOW DOWN ***
HumptyD: shows [As 5s] (high card Ace)
Quantum771: shows [Qd Qc] (a pair of Queens)
Quantum771 collected $1.16 from pot
*** SUMMARY ***
Total pot $1.20 | Rake $0.04
Board [Td Kc 6s 9h 3h]
Seat 1: matheus f 97 (button) folded before Flop
Seat 2: HumptyD (small blind) showed [As 5s] and lost with high card Ace
Seat 3: Quantum771 (big blind) showed [Qd Qc] and won ($1.16) with a pair of Queens
Seat 4: argent55 folded before Flop (didn't bet)
Seat 5: Mr_Supp31 folded before Flop (didn't bet)
Seat 6: lamosca51 folded before Flop (didn't bet)

PokerStars Zoom Hand #250961282941:  Hold'em No Limit ($0.01/$0.02) - 2024/06/10 19:25:56 ET
Table 'Halley' 6-max Seat #1 is the button
Seat 1: praznina ($3.21 in chips)
Seat 2: Matzet1ka ($2.27 in chips)
Seat 3: gra44fun ($2.42 in chips)
Seat 4: Quantum771 ($2.59 in chips)
Seat 5: HumptyD ($2 in chips)
Seat 6: RafaByPoker ($2.58 in chips)
Matzet1ka: posts small blind $0.01
gra44fun: posts big blind $0.02
*** HOLE CARDS ***
Dealt to HumptyD [Qc 8c]
Quantum771: folds
HumptyD: raises $0.04 to $0.06
RafaByPoker: folds
praznina: folds
Matzet1ka: folds
gra44fun: folds
Uncalled bet ($0.04) returned to HumptyD
HumptyD collected $0.05 from pot
HumptyD: doesn't show hand
*** SUMMARY ***
Total pot $0.05 | Rake $0
Seat 1: praznina (button) folded before Flop (didn't bet)
Seat 2: Matzet1ka (small blind) folded before Flop
Seat 3: gra44fun (big blind) folded before Flop
Seat 4: Quantum771 folded before Flop (didn't bet)
Seat 5: HumptyD collected ($0.05)
Seat 6: RafaByPoker folded before Flop (didn't bet)

PokerStars Zoom Hand #250961285371:  Hold'em No Limit ($0.01/$0.02) - 2024/06/10 19:26:07 ET
Table 'Halley' 6-max Seat #1 is the button
Seat 1: hibyz ($3.09 in chips)
Seat 2: S@LTY"CTM" ($1.70 in chips)
Seat 3: mr_maxsize ($3.59 in chips)
Seat 4: HumptyD ($2.03 in chips)
Seat 5: nicooIN ($1.36 in chips)
Seat 6: TAVINHOROOTS ($2.11 in chips)
S@LTY"CTM": posts small blind $0.01
mr_maxsize: posts big blind $0.02
*** HOLE CARDS ***
Dealt to HumptyD [9h 5d]
HumptyD: folds
nicooIN: folds
TAVINHOROOTS: folds
hibyz: folds
S@LTY"CTM": folds
Uncalled bet ($0.01) returned to mr_maxsize
mr_maxsize collected $0.02 from pot
mr_maxsize: doesn't show hand
*** SUMMARY ***
Total pot $0.02 | Rake $0
Seat 1: hibyz (button) folded before Flop (didn't bet)
Seat 2: S@LTY"CTM" (small blind) folded before Flop
Seat 3: mr_maxsize (big blind) collected ($0.02)
Seat 4: HumptyD folded before Flop (didn't bet)
Seat 5: nicooIN folded before Flop (didn't bet)
Seat 6: TAVINHOROOTS folded before Flop (didn't bet)

PokerStars Zoom Hand #250961288245:  Hold'em No Limit ($0.01/$0.02) - 2024/06/10 19:26:20 ET
Table 'Halley' 6-max Seat #1 is the button
Seat 1: R!usonken ($2.05 in chips)
Seat 2: HumptyD ($2.03 in chips)
Seat 3: praznina ($0.64 in chips)
Seat 4: TAVINHOROOTS ($2.11 in chips)
Seat 5: maykolpb ($1.14 in chips)
Seat 6: Amazonia2010 ($2.02 in chips)
HumptyD: posts small blind $0.01
praznina: posts big blind $0.02
*** HOLE CARDS ***
Dealt to HumptyD [9h Tc]
TAVINHOROOTS: folds
maykolpb: raises $0.04 to $0.06
Amazonia2010: folds
R!usonken: folds
HumptyD: folds
praznina: raises $0.10 to $0.16
maykolpb: raises $0.98 to $1.14 and is all-in
praznina: folds
Uncalled bet ($0.98) returned to maykolpb
maykolpb collected $0.33 from pot
maykolpb: doesn't show hand
*** SUMMARY ***
Total pot $0.33 | Rake $0
Seat 1: R!usonken (button) folded before Flop (didn't bet)
Seat 2: HumptyD (small blind) folded before Flop
Seat 3: praznina (big blind) folded before Flop
Seat 4: TAVINHOROOTS folded before Flop (didn't bet)
Seat 5: maykolpb collected ($0.33)
Seat 6: Amazonia2010 folded before Flop (didn't bet)

PokerStars Zoom Hand #250961286921:  Hold'em No Limit ($0.01/$0.02) - 2024/06/10 19:26:14 ET
Table 'Halley' 6-max Seat #1 is the button
Seat 1: S@LTY"CTM" ($1.69 in chips)
Seat 2: matheus f 97 ($2.41 in chips)
Seat 3: Matzet1ka ($2 in chips)
Seat 4: thevillian74 ($1.02 in chips)
Seat 5: 15Thousand ($1.14 in chips)
Seat 6: HumptyD ($2.03 in chips)
matheus f 97: posts small blind $0.01
Matzet1ka: posts big blind $0.02
*** HOLE CARDS ***
Dealt to HumptyD [Kd 2h]
thevillian74: raises $0.02 to $0.04
15Thousand: folds
HumptyD: folds
S@LTY"CTM": calls $0.04
matheus f 97: calls $0.03
Matzet1ka: folds
*** FLOP *** [6d 7c 3c]
matheus f 97: checks
thevillian74: checks
S@LTY"CTM": checks
*** TURN *** [6d 7c 3c] [2s]
matheus f 97: checks
thevillian74: checks
S@LTY"CTM": checks
*** RIVER *** [6d 7c 3c 2s] [Jd]
matheus f 97: bets $0.07
thevillian74: folds
S@LTY"CTM": folds
Uncalled bet ($0.07) returned to matheus f 97
matheus f 97 collected $0.14 from pot
matheus f 97: doesn't show hand
*** SUMMARY ***
Total pot $0.14 | Rake $0
Board [6d 7c 3c 2s Jd]
Seat 1: S@LTY"CTM" (button) folded on the River
Seat 2: matheus f 97 (small blind) collected ($0.14)
Seat 3: Matzet1ka (big blind) folded before Flop
Seat 4: thevillian74 folded on the River
Seat 5: 15Thousand folded before Flop (didn't bet)
Seat 6: HumptyD folded before Flop (didn't bet)

PokerStars Zoom Hand #250961293307:  Hold'em No Limit ($0.01/$0.02) - 2024/06/10 19:26:43 ET
Table 'Halley' 6-max Seat #1 is the button
Seat 1: HumptyD ($2 in chips)
Seat 2: Shakalas248 ($4.15 in chips)
Seat 3: Tio Jhonas ($0.92 in chips)
Seat 4: Crepaldi_119 ($1.07 in chips)
Seat 5: Keltu :D ($2.49 in chips)
Seat 6: Johnis111 ($1.98 in chips)
Shakalas248: posts small blind $0.01
Tio Jhonas: posts big blind $0.02
*** HOLE CARDS ***
Dealt to HumptyD [Js Ks]
Crepaldi_119: folds
Keltu :D: folds
Johnis111: folds
HumptyD: raises $0.04 to $0.06
Shakalas248: folds
Tio Jhonas: folds
Uncalled bet ($0.04) returned to HumptyD
HumptyD collected $0.05 from pot
HumptyD: doesn't show hand
*** SUMMARY ***
Total pot $0.05 | Rake $0
Seat 1: HumptyD (button) collected ($0.05)
Seat 2: Shakalas248 (small blind) folded before Flop
Seat 3: Tio Jhonas (big blind) folded before Flop
Seat 4: Crepaldi_119 folded before Flop (didn't bet)
Seat 5: Keltu :D folded before Flop (didn't bet)
Seat 6: Johnis111 folded before Flop (didn't bet)

PokerStars Zoom Hand #250961290242:  Hold'em No Limit ($0.01/$0.02) - 2024/06/10 19:26:29 ET
Table 'Halley' 6-max Seat #1 is the button
Seat 1: PITUCAV ($2 in chips)
Seat 2: descandy ($2.07 in chips)
Seat 3: HumptyD ($2.02 in chips)
Seat 4: slidepop ($3.02 in chips)
Seat 5: Peebo-Nard ($6.98 in chips)
Seat 6: Freestyle_Bnet ($2 in chips)
descandy: posts small blind $0.01
HumptyD: posts big blind $0.02
*** HOLE CARDS ***
Dealt to HumptyD [7c Kd]
slidepop: folds
Peebo-Nard: folds
Freestyle_Bnet: raises $0.03 to $0.05
PITUCAV: folds
descandy: calls $0.04
HumptyD: folds
*** FLOP *** [2s 9s 6d]
descandy: checks
Freestyle_Bnet: checks
*** TURN *** [2s 9s 6d] [8c]
descandy: bets $0.07
Freestyle_Bnet: folds
Uncalled bet ($0.07) returned to descandy
descandy collected $0.12 from pot
descandy: doesn't show hand
*** SUMMARY ***
Total pot $0.12 | Rake $0
Board [2s 9s 6d 8c]
Seat 1: PITUCAV (button) folded before Flop (didn't bet)
Seat 2: descandy (small blind) collected ($0.12)
Seat 3: HumptyD (big blind) folded before Flop
Seat 4: slidepop folded before Flop (didn't bet)
Seat 5: Peebo-Nard folded before Flop (didn't bet)
Seat 6: Freestyle_Bnet folded on the Turn

PokerStars Zoom Hand #250961299956:  Hold'em No Limit ($0.01/$0.02) - 2024/06/10 19:27:13 ET
Table 'Halley' 6-max Seat #1 is the button
Seat 1: BradonTok ($2.87 in chips)
Seat 2: TAVINHOROOTS ($2.03 in chips)
Seat 3: Poleza-51 ($1.86 in chips)
Seat 4: BeGoat ($1.45 in chips)
Seat 5: Mr_Supp31 ($1.43 in chips)
Seat 6: HumptyD ($2.03 in chips)
TAVINHOROOTS: posts small blind $0.01
Poleza-51: posts big blind $0.02
*** HOLE CARDS ***
Dealt to HumptyD [6h 2h]
BeGoat: folds
Mr_Supp31: folds
HumptyD: folds
BradonTok: folds
TAVINHOROOTS: folds
Uncalled bet ($0.01) returned to Poleza-51
Poleza-51 collected $0.02 from pot
Poleza-51: doesn't show hand
*** SUMMARY ***
Total pot $0.02 | Rake $0
Seat 1: BradonTok (button) folded before Flop (didn't bet)
Seat 2: TAVINHOROOTS (small blind) folded before Flop
Seat 3: Poleza-51 (big blind) collected ($0.02)
Seat 4: BeGoat folded before Flop (didn't bet)
Seat 5: Mr_Supp31 folded before Flop (didn't bet)
Seat 6: HumptyD folded before Flop (didn't bet)

PokerStars Zoom Hand #250961303966:  Hold'em No Limit ($0.01/$0.02) - 2024/06/10 19:27:31 ET
Table 'Halley' 6-max Seat #1 is the button
Seat 1: HumptyD ($2.01 in chips)
Seat 2: BradonTok ($2.85 in chips)
Seat 3: Zoom Zap ($3.52 in chips)
Seat 4: bord258 ($2.05 in chips)
Seat 5: mr_maxsize ($4.63 in chips)
Seat 6: bettanye ($2 in chips)
BradonTok: posts small blind $0.01
Zoom Zap: posts big blind $0.02
*** HOLE CARDS ***
Dealt to HumptyD [3c Ts]
bord258: folds
mr_maxsize: folds
bettanye: raises $0.03 to $0.05
HumptyD: folds
BradonTok: folds
Zoom Zap: folds
Uncalled bet ($0.03) returned to bettanye
bettanye collected $0.05 from pot
bettanye: doesn't show hand
*** SUMMARY ***
Total pot $0.05 | Rake $0
Seat 1: HumptyD (button) folded before Flop (didn't bet)
Seat 2: BradonTok (small blind) folded before Flop
Seat 3: Zoom Zap (big blind) folded before Flop
Seat 4: bord258 folded before Flop (didn't bet)
Seat 5: mr_maxsize folded before Flop (didn't bet)
Seat 6: bettanye collected ($0.05)

PokerStars Zoom Hand #250961298145:  Hold'em No Limit ($0.01/$0.02) - 2024/06/10 19:27:05 ET
Table 'Halley' 6-max Seat #1 is the button
Seat 1: pumpkidd ($2 in chips)
Seat 2: RafaByPoker ($2.16 in chips)
Seat 3: argent55 ($3.61 in chips)
Seat 4: Digulits ($4.70 in chips)
Seat 5: HumptyD ($2.03 in chips)
Seat 6: brenopmo ($2 in chips)
RafaByPoker: posts small blind $0.01
argent55: posts big blind $0.02
*** HOLE CARDS ***
Dealt to HumptyD [3c 7h]
Digulits: raises $0.02 to $0.04
HumptyD: folds
brenopmo: folds
pumpkidd: folds
RafaByPoker: calls $0.03
argent55: folds
*** FLOP *** [4c 6s Ah]
RafaByPoker: checks
Digulits: bets $0.05
RafaByPoker: folds
Uncalled bet ($0.05) returned to Digulits
Digulits collected $0.10 from pot
Digulits: doesn't show hand
*** SUMMARY ***
Total pot $0.10 | Rake $0
Board [4c 6s Ah]
Seat 1: pumpkidd (button) folded before Flop (didn't bet)
Seat 2: RafaByPoker (small blind) folded on the Flop
Seat 3: argent55 (big blind) folded before Flop
Seat 4: Digulits collected ($0.10)
Seat 5: HumptyD folded before Flop (didn't bet)
Seat 6: brenopmo folded before Flop (didn't bet)

PokerStars Zoom Hand #250961305729:  Hold'em No Limit ($0.01/$0.02) - 2024/06/10 19:27:39 ET
Table 'Halley' 6-max Seat #1 is the button
Seat 1: Anuar Zhan star ($3.47 in chips)
Seat 2: HumptyD ($2.01 in chips)
Seat 3: Tio Jhonas ($0.89 in chips)
Seat 4: Rabbitsz ($3.97 in chips)
Seat 5: brenopmo ($2 in chips)
Seat 6: argent55 ($3.59 in chips)
HumptyD: posts small blind $0.01
Tio Jhonas: posts big blind $0.02
*** HOLE CARDS ***
Dealt to HumptyD [Tc 4d]
Rabbitsz: folds
brenopmo: folds
argent55: folds
Anuar Zhan star: folds
HumptyD: folds
Uncalled bet ($0.01) returned to Tio Jhonas
Tio Jhonas collected $0.02 from pot
Tio Jhonas: doesn't show hand
*** SUMMARY ***
Total pot $0.02 | Rake $0
Seat 1: Anuar Zhan star (button) folded before Flop (didn't bet)
Seat 2: HumptyD (small blind) folded before Flop
Seat 3: Tio Jhonas (big blind) collected ($0.02)
Seat 4: Rabbitsz folded before Flop (didn't bet)
Seat 5: brenopmo folded before Flop (didn't bet)
Seat 6: argent55 folded before Flop (didn't bet)

PokerStars Zoom Hand #250961301056:  Hold'em No Limit ($0.01/$0.02) - 2024/06/10 19:27:18 ET
Table 'Halley' 6-max Seat #1 is the button
Seat 1: praznina ($3.13 in chips)
Seat 2: WB_SOH ($2.94 in chips)
Seat 3: HumptyD ($2.03 in chips)
Seat 4: ramirodl'b ($2.75 in chips)
Seat 5: invictusfp ($1.93 in chips)
Seat 6: Luciano V609 ($4.16 in chips)
WB_SOH: posts small blind $0.01
HumptyD: posts big blind $0.02
*** HOLE CARDS ***
Dealt to HumptyD [8h 9h]
ramirodl'b: folds
invictusfp: raises $0.03 to $0.05
Luciano V609: calls $0.05
praznina: raises $0.07 to $0.12
WB_SOH: raises $0.31 to $0.43
HumptyD: folds
invictusfp: folds
Luciano V609: folds
praznina: folds
Uncalled bet ($0.31) returned to WB_SOH
WB_SOH collected $0.36 from pot
WB_SOH: doesn't show hand
*** SUMMARY ***
Total pot $0.36 | Rake $0
Seat 1: praznina (button) folded before Flop
Seat 2: WB_SOH (small blind) collected ($0.36)
Seat 3: HumptyD (big blind) folded before Flop
Seat 4: ramirodl'b folded before Flop (didn't bet)
Seat 5: invictusfp folded before Flop
Seat 6: Luciano V609 folded before Flop

PokerStars Zoom Hand #250961306601:  Hold'em No Limit ($0.01/$0.02) - 2024/06/10 19:27:43 ET
Table 'Halley' 6-max Seat #1 is the button
Seat 1: jackdanius ($2 in chips)
Seat 2: Rabbitsz ($3.97 in chips)
Seat 3: steel_gabriel ($2.95 in chips)
Seat 4: HumptyD ($2 in chips)
Seat 5: descandy ($2.12 in chips)
Seat 6: RafaByPoker ($2.12 in chips)
Rabbitsz: posts small blind $0.01
steel_gabriel: posts big blind $0.02
*** HOLE CARDS ***
Dealt to HumptyD [Ts Tc]
HumptyD: raises $0.04 to $0.06
steel_gabriel is disconnected
descandy: folds
RafaByPoker: folds
jackdanius: folds
Rabbitsz: folds
steel_gabriel has timed out while disconnected
steel_gabriel: folds
Uncalled bet ($0.04) returned to HumptyD
HumptyD collected $0.05 from pot
HumptyD: doesn't show hand
*** SUMMARY ***
Total pot $0.05 | Rake $0
Seat 1: jackdanius (button) folded before Flop (didn't bet)
Seat 2: Rabbitsz (small blind) folded before Flop
Seat 3: steel_gabriel (big blind) folded before Flop
Seat 4: HumptyD collected ($0.05)
Seat 5: descandy folded before Flop (didn't bet)
Seat 6: RafaByPoker folded before Flop (didn't bet)

PokerStars Zoom Hand #250961315111:  Hold'em No Limit ($0.01/$0.02) - 2024/06/10 19:28:23 ET
Table 'Halley' 6-max Seat #1 is the button
Seat 1: S@LTY"CTM" ($6.27 in chips)
Seat 2: Peebo-Nard ($6.88 in chips)
Seat 3: aricast19 ($2.01 in chips)
Seat 4: HumptyD ($2.03 in chips)
Seat 5: zandoná_cont ($0.44 in chips)
Seat 6: mr_maxsize ($2.56 in chips)
Peebo-Nard: posts small blind $0.01
aricast19: posts big blind $0.02
*** HOLE CARDS ***
Dealt to HumptyD [9h 6h]
HumptyD: folds
zandoná_cont: folds
mr_maxsize: folds
S@LTY"CTM": calls $0.02
Peebo-Nard: folds
aricast19: checks
*** FLOP *** [Kd Kh Tc]
aricast19: checks
S@LTY"CTM": checks
*** TURN *** [Kd Kh Tc] [Js]
aricast19: checks
S@LTY"CTM": checks
*** RIVER *** [Kd Kh Tc Js] [5h]
aricast19: checks
S@LTY"CTM": checks
*** SHOW DOWN ***
aricast19: shows [Jd 8s] (two pair, Kings and Jacks)
S@LTY"CTM": mucks hand
aricast19 collected $0.05 from pot
*** SUMMARY ***
Total pot $0.05 | Rake $0
Board [Kd Kh Tc Js 5h]
Seat 1: S@LTY"CTM" (button) mucked [6d 7s]
Seat 2: Peebo-Nard (small blind) folded before Flop
Seat 3: aricast19 (big blind) showed [Jd 8s] and won ($0.05) with two pair, Kings and Jacks
Seat 4: HumptyD folded before Flop (didn't bet)
Seat 5: zandoná_cont folded before Flop (didn't bet)
Seat 6: mr_maxsize folded before Flop (didn't bet)

PokerStars Zoom Hand #250961322005:  Hold'em No Limit ($0.01/$0.02) - 2024/06/10 19:28:55 ET
Table 'Halley' 6-max Seat #1 is the button
Seat 1: brunoafrao ($1.28 in chips)
Seat 2: S@LTY"CTM" ($1.50 in chips)
Seat 3: WB_SOH ($2.38 in chips)
Seat 4: PR43Brazil ($3.31 in chips)
Seat 5: ARatherFitGuy ($1.62 in chips)
Seat 6: HumptyD ($2.03 in chips)
S@LTY"CTM": posts small blind $0.01
WB_SOH: posts big blind $0.02
*** HOLE CARDS ***
Dealt to HumptyD [Qc 9s]
PR43Brazil: folds
ARatherFitGuy: folds
HumptyD: folds
brunoafrao: folds
S@LTY"CTM": folds
Uncalled bet ($0.01) returned to WB_SOH
WB_SOH collected $0.02 from pot
WB_SOH: doesn't show hand
*** SUMMARY ***
Total pot $0.02 | Rake $0
Seat 1: brunoafrao (button) folded before Flop (didn't bet)
Seat 2: S@LTY"CTM" (small blind) folded before Flop
Seat 3: WB_SOH (big blind) collected ($0.02)
Seat 4: PR43Brazil folded before Flop (didn't bet)
Seat 5: ARatherFitGuy folded before Flop (didn't bet)
Seat 6: HumptyD folded before Flop (didn't bet)

PokerStars Zoom Hand #250961318494:  Hold'em No Limit ($0.01/$0.02) - 2024/06/10 19:28:39 ET
Table 'Halley' 6-max Seat #1 is the button
Seat 1: Peebo-Nard ($10.52 in chips)
Seat 2: ildivodeoro ($2.12 in chips)
Seat 3: alsec93 ($5.53 in chips)
Seat 4: gomita31 ($2.38 in chips)
Seat 5: HumptyD ($2.03 in chips)
Seat 6: descandy ($2.08 in chips)
ildivodeoro: posts small blind $0.01
alsec93: posts big blind $0.02
*** HOLE CARDS ***
Dealt to HumptyD [6s 7c]
gomita31: folds
HumptyD: folds
descandy: raises $0.04 to $0.06
Peebo-Nard: folds
ildivodeoro: folds
alsec93: calls $0.04
*** FLOP *** [Jh Ks 4s]
alsec93: checks
descandy: bets $0.06
alsec93: calls $0.06
*** TURN *** [Jh Ks 4s] [2d]
alsec93: checks
descandy: checks
*** RIVER *** [Jh Ks 4s 2d] [Jd]
alsec93: checks
descandy: checks
*** SHOW DOWN ***
alsec93: shows [5c Kc] (two pair, Kings and Jacks)
descandy: mucks hand
alsec93 collected $0.24 from pot
*** SUMMARY ***
Total pot $0.25 | Rake $0.01
Board [Jh Ks 4s 2d Jd]
Seat 1: Peebo-Nard (button) folded before Flop (didn't bet)
Seat 2: ildivodeoro (small blind) folded before Flop
Seat 3: alsec93 (big blind) showed [5c Kc] and won ($0.24) with two pair, Kings and Jacks
Seat 4: gomita31 folded before Flop (didn't bet)
Seat 5: HumptyD folded before Flop (didn't bet)
Seat 6: descandy mucked [As 9s]

PokerStars Zoom Hand #250961327420:  Hold'em No Limit ($0.01/$0.02) - 2024/06/10 19:29:20 ET
Table 'Halley' 6-max Seat #1 is the button
Seat 1: Freestyle_Bnet ($2.12 in chips)
Seat 2: HumptyD ($2.01 in chips)
Seat 3: invictusfp ($3.86 in chips)
Seat 4: gary01407 ($9.01 in chips)
Seat 5: BradonTok ($2.44 in chips)
Seat 6: prwlgwolf77 ($2.06 in chips)
HumptyD: posts small blind $0.01
invictusfp: posts big blind $0.02
*** HOLE CARDS ***
Dealt to HumptyD [6s Ts]
gary01407: folds
BradonTok: folds
prwlgwolf77: raises $0.03 to $0.05
Freestyle_Bnet: raises $0.10 to $0.15
HumptyD: folds
invictusfp: folds
prwlgwolf77: folds
Uncalled bet ($0.10) returned to Freestyle_Bnet
Freestyle_Bnet collected $0.13 from pot
Freestyle_Bnet: doesn't show hand
*** SUMMARY ***
Total pot $0.13 | Rake $0
Seat 1: Freestyle_Bnet (button) collected ($0.13)
Seat 2: HumptyD (small blind) folded before Flop
Seat 3: invictusfp (big blind) folded before Flop
Seat 4: gary01407 folded before Flop (didn't bet)
Seat 5: BradonTok folded before Flop (didn't bet)
Seat 6: prwlgwolf77 folded before Flop

PokerStars Zoom Hand #250961323715:  Hold'em No Limit ($0.01/$0.02) - 2024/06/10 19:29:03 ET
Table 'Halley' 6-max Seat #1 is the button
Seat 1: mr_maxsize ($5.01 in chips)
Seat 2: brunoafrao ($1.72 in chips)
Seat 3: HumptyD ($2.03 in chips)
Seat 4: FrancoOlmedo ($2.12 in chips)
Seat 5: teoortiz21 ($1.96 in chips)
Seat 6: maldobex ($2.30 in chips)
brunoafrao: posts small blind $0.01
HumptyD: posts big blind $0.02
*** HOLE CARDS ***
Dealt to HumptyD [Th Qc]
FrancoOlmedo: raises $0.04 to $0.06
teoortiz21: folds
maldobex: folds
mr_maxsize: folds
brunoafrao: calls $0.05
HumptyD: folds
*** FLOP *** [2c Tc Ts]
brunoafrao: checks
FrancoOlmedo: checks
*** TURN *** [2c Tc Ts] [5h]
brunoafrao: bets $0.09
FrancoOlmedo: folds
Uncalled bet ($0.09) returned to brunoafrao
brunoafrao collected $0.14 from pot
brunoafrao: doesn't show hand
*** SUMMARY ***
Total pot $0.14 | Rake $0
Board [2c Tc Ts 5h]
Seat 1: mr_maxsize (button) folded before Flop (didn't bet)
Seat 2: brunoafrao (small blind) collected ($0.14)
Seat 3: HumptyD (big blind) folded before Flop
Seat 4: FrancoOlmedo folded on the Turn
Seat 5: teoortiz21 folded before Flop (didn't bet)
Seat 6: maldobex folded before Flop (didn't bet)

PokerStars Zoom Hand #250961329745:  Hold'em No Limit ($0.01/$0.02) - 2024/06/10 19:29:31 ET
Table 'Halley' 6-max Seat #1 is the button
Seat 1: HumptyD ($2 in chips)
Seat 2: capuuh ($2.06 in chips)
Seat 3: BaStEr001213 ($1.35 in chips)
Seat 4: bettanye ($2.12 in chips)
Seat 5: keky_144 ($1.60 in chips)
Seat 6: MacPoker19 ($2.29 in chips)
capuuh: posts small blind $0.01
BaStEr001213: posts big blind $0.02
*** HOLE CARDS ***
Dealt to HumptyD [9s Kh]
bettanye: raises $0.03 to $0.05
keky_144: folds
MacPoker19: folds
HumptyD: folds
capuuh: folds
BaStEr001213: raises $0.11 to $0.16
bettanye: folds
Uncalled bet ($0.11) returned to BaStEr001213
BaStEr001213 collected $0.11 from pot
BaStEr001213: doesn't show hand
*** SUMMARY ***
Total pot $0.11 | Rake $0
Seat 1: HumptyD (button) folded before Flop (didn't bet)
Seat 2: capuuh (small blind) folded before Flop
Seat 3: BaStEr001213 (big blind) collected ($0.11)
Seat 4: bettanye folded before Flop
Seat 5: keky_144 folded before Flop (didn't bet)
Seat 6: MacPoker19 folded before Flop (didn't bet)

PokerStars Zoom Hand #250961326094:  Hold'em No Limit ($0.01/$0.02) - 2024/06/10 19:29:14 ET
Table 'Halley' 6-max Seat #1 is the button
Seat 1: ARatherFitGuy ($1.60 in chips)
Seat 2: shampu10p ($1.78 in chips)
Seat 3: 3 pair kid ($1.48 in chips)
Seat 4: HumptyD ($2.01 in chips)
Seat 5: bryld2 ($2.06 in chips)
Seat 6: JMassensini ($4.11 in chips)
shampu10p: posts small blind $0.01
3 pair kid: posts big blind $0.02
*** HOLE CARDS ***
Dealt to HumptyD [2h 8d]
HumptyD: folds
bryld2: raises $0.06 to $0.08
JMassensini: folds
ARatherFitGuy: calls $0.08
shampu10p: calls $0.07
3 pair kid: calls $0.06
*** FLOP *** [Qd 9c 5s]
shampu10p: checks
3 pair kid: checks
bryld2: checks
ARatherFitGuy: bets $0.31
shampu10p: folds
3 pair kid: folds
bryld2: folds
Uncalled bet ($0.31) returned to ARatherFitGuy
ARatherFitGuy collected $0.31 from pot
ARatherFitGuy: doesn't show hand
*** SUMMARY ***
Total pot $0.32 | Rake $0.01
Board [Qd 9c 5s]
Seat 1: ARatherFitGuy (button) collected ($0.31)
Seat 2: shampu10p (small blind) folded on the Flop
Seat 3: 3 pair kid (big blind) folded on the Flop
Seat 4: HumptyD folded before Flop (didn't bet)
Seat 5: bryld2 folded on the Flop
Seat 6: JMassensini folded before Flop (didn't bet)

PokerStars Zoom Hand #250961331476:  Hold'em No Limit ($0.01/$0.02) - 2024/06/10 19:29:39 ET
Table 'Halley' 6-max Seat #1 is the button
Seat 1: S@LTY"CTM" ($1.47 in chips)
Seat 2: invictusfp ($3.84 in chips)
Seat 3: HumptyD ($2 in chips)
Seat 4: descandy ($2.12 in chips)
Seat 5: Johnis111 ($1.93 in chips)
Seat 6: pumpkidd ($2.62 in chips)
invictusfp: posts small blind $0.01
HumptyD: posts big blind $0.02
*** HOLE CARDS ***
Dealt to HumptyD [Ks 6d]
descandy: folds
Johnis111: folds
pumpkidd: raises $0.04 to $0.06
S@LTY"CTM": folds
invictusfp: folds
HumptyD: folds
Uncalled bet ($0.04) returned to pumpkidd
pumpkidd collected $0.05 from pot
pumpkidd: doesn't show hand
*** SUMMARY ***
Total pot $0.05 | Rake $0
Seat 1: S@LTY"CTM" (button) folded before Flop (didn't bet)
Seat 2: invictusfp (small blind) folded before Flop
Seat 3: HumptyD (big blind) folded before Flop
Seat 4: descandy folded before Flop (didn't bet)
Seat 5: Johnis111 folded before Flop (didn't bet)
Seat 6: pumpkidd collected ($0.05)

PokerStars Zoom Hand #250961338942:  Hold'em No Limit ($0.01/$0.02) - 2024/06/10 19:30:13 ET
Table 'Halley' 6-max Seat #1 is the button
Seat 1: -analisante- ($2.79 in chips)
Seat 2: WB_SOH ($3.38 in chips)
Seat 3: bryld2 ($2 in chips)
Seat 4: TONY K995 ($2.43 in chips)
Seat 5: praznina ($1.96 in chips)
Seat 6: HumptyD ($2 in chips)
WB_SOH: posts small blind $0.01
bryld2: posts big blind $0.02
*** HOLE CARDS ***
Dealt to HumptyD [5c Ac]
TONY K995: folds
praznina: folds
HumptyD: raises $0.04 to $0.06
-analisante-: folds
WB_SOH: raises $0.17 to $0.23
bryld2: folds
HumptyD: calls $0.17
*** FLOP *** [3c Th Js]
WB_SOH: bets $0.27
HumptyD: folds
Uncalled bet ($0.27) returned to WB_SOH
WB_SOH collected $0.46 from pot
WB_SOH: doesn't show hand
*** SUMMARY ***
Total pot $0.48 | Rake $0.02
Board [3c Th Js]
Seat 1: -analisante- (button) folded before Flop (didn't bet)
Seat 2: WB_SOH (small blind) collected ($0.46)
Seat 3: bryld2 (big blind) folded before Flop
Seat 4: TONY K995 folded before Flop (didn't bet)
Seat 5: praznina folded before Flop (didn't bet)
Seat 6: HumptyD folded on the Flop

PokerStars Zoom Hand #250961355568:  Hold'em No Limit ($0.01/$0.02) - 2024/06/10 19:31:30 ET
Table 'Halley' 6-max Seat #1 is the button
Seat 1: Invron11 ($3.13 in chips)
Seat 2: lewisweight ($3.37 in chips)
Seat 3: matheus f 97 ($2.45 in chips)
Seat 4: mr_maxsize ($5.22 in chips)
Seat 5: HumptyD ($2 in chips)
Seat 6: Johnis111 ($1.97 in chips)
lewisweight: posts small blind $0.01
matheus f 97: posts big blind $0.02
*** HOLE CARDS ***
Dealt to HumptyD [6c Qs]
mr_maxsize: folds
HumptyD: folds
Johnis111: folds
Invron11: folds
lewisweight: folds
Uncalled bet ($0.01) returned to matheus f 97
matheus f 97 collected $0.02 from pot
matheus f 97: doesn't show hand
*** SUMMARY ***
Total pot $0.02 | Rake $0
Seat 1: Invron11 (button) folded before Flop (didn't bet)
Seat 2: lewisweight (small blind) folded before Flop
Seat 3: matheus f 97 (big blind) collected ($0.02)
Seat 4: mr_maxsize folded before Flop (didn't bet)
Seat 5: HumptyD folded before Flop (didn't bet)
Seat 6: Johnis111 folded before Flop (didn't bet)

PokerStars Zoom Hand #250961356848:  Hold'em No Limit ($0.01/$0.02) - 2024/06/10 19:31:36 ET
Table 'Halley' 6-max Seat #1 is the button
Seat 1: Dorie Danko ($2.23 in chips)
Seat 2: backgamer10 ($0.64 in chips)
Seat 3: guiperobelli123 ($3.73 in chips)
Seat 4: Johnis111 ($1.97 in chips)
Seat 5: HumptyD ($2 in chips)
Seat 6: capuuh ($2 in chips)
backgamer10: posts small blind $0.01
guiperobelli123: posts big blind $0.02
*** HOLE CARDS ***
Dealt to HumptyD [Qc Qh]
Johnis111: raises $0.07 to $0.09
HumptyD: raises $0.21 to $0.30
capuuh: folds
Dorie Danko: folds
backgamer10: raises $0.34 to $0.64 and is all-in
guiperobelli123: folds
Johnis111: raises $1.33 to $1.97 and is all-in
HumptyD: calls $1.67
Johnis111 has timed out
*** FLOP *** [Td 6s Ks]
*** TURN *** [Td 6s Ks] [7s]
*** RIVER *** [Td 6s Ks 7s] [2d]
*** SHOW DOWN ***
Johnis111: shows [Kh Kc] (three of a kind, Kings)
HumptyD: shows [Qc Qh] (a pair of Queens)
Johnis111 collected $2.57 from side pot
backgamer10: shows [9c 9h] (a pair of Nines)
Johnis111 collected $1.87 from main pot
backgamer10 cashed out the hand for $0.29 | Cash Out Fee $0.01
*** SUMMARY ***
Total pot $4.60 Main pot $1.87. Side pot $2.57. | Rake $0.16
Board [Td 6s Ks 7s 2d]
Seat 1: Dorie Danko (button) folded before Flop (didn't bet)
Seat 2: backgamer10 (small blind) showed [9c 9h] and lost with a pair of Nines (cashed out).
Seat 3: guiperobelli123 (big blind) folded before Flop
Seat 4: Johnis111 showed [Kh Kc] and won ($4.44) with three of a kind, Kings
Seat 5: HumptyD showed [Qc Qh] and lost with a pair of Queens
Seat 6: capuuh folded before Flop (didn't bet)

PokerStars Zoom Hand #250961368078:  Hold'em No Limit ($0.01/$0.02) - 2024/06/10 19:32:28 ET
Table 'Halley' 6-max Seat #1 is the button
Seat 1: HumptyD ($2 in chips)
Seat 2: TSCardinals ($2 in chips)
Seat 3: mr_maxsize ($2.93 in chips)
Seat 4: viiv750 ($2 in chips)
Seat 5: coolDadJimbo ($6.69 in chips)
Seat 6: brunoafrao ($1.93 in chips)
TSCardinals: posts small blind $0.01
mr_maxsize: posts big blind $0.02
*** HOLE CARDS ***
Dealt to HumptyD [3h 6h]
viiv750: folds
coolDadJimbo: folds
brunoafrao: folds
HumptyD: folds
TSCardinals: folds
Uncalled bet ($0.01) returned to mr_maxsize
mr_maxsize collected $0.02 from pot
mr_maxsize: doesn't show hand
*** SUMMARY ***
Total pot $0.02 | Rake $0
Seat 1: HumptyD (button) folded before Flop (didn't bet)
Seat 2: TSCardinals (small blind) folded before Flop
Seat 3: mr_maxsize (big blind) collected ($0.02)
Seat 4: viiv750 folded before Flop (didn't bet)
Seat 5: coolDadJimbo folded before Flop (didn't bet)
Seat 6: brunoafrao folded before Flop (didn't bet)

PokerStars Zoom Hand #250961375259:  Hold'em No Limit ($0.01/$0.02) - 2024/06/10 19:33:03 ET
Table 'Halley' 6-max Seat #1 is the button
Seat 1: mr_maxsize ($5.30 in chips)
Seat 2: capuuh ($2.03 in chips)
Seat 3: PITUCAV ($2.08 in chips)
Seat 4: HumptyD ($2 in chips)
Seat 5: Dorie Danko ($1.63 in chips)
Seat 6: Freestyle_Bnet ($2.77 in chips)
capuuh: posts small blind $0.01
PITUCAV: posts big blind $0.02
*** HOLE CARDS ***
Dealt to HumptyD [Ac Ah]
HumptyD: raises $0.04 to $0.06
Dorie Danko: folds
Freestyle_Bnet: folds
mr_maxsize: folds
capuuh: folds
PITUCAV: calls $0.04
*** FLOP *** [3d Qc 3c]
PITUCAV: checks
HumptyD: bets $0.03
PITUCAV: folds
Uncalled bet ($0.03) returned to HumptyD
HumptyD collected $0.13 from pot
HumptyD: doesn't show hand
*** SUMMARY ***
Total pot $0.13 | Rake $0
Board [3d Qc 3c]
Seat 1: mr_maxsize (button) folded before Flop (didn't bet)
Seat 2: capuuh (small blind) folded before Flop
Seat 3: PITUCAV (big blind) folded on the Flop
Seat 4: HumptyD collected ($0.13)
Seat 5: Dorie Danko folded before Flop (didn't bet)
Seat 6: Freestyle_Bnet folded before Flop (didn't bet)

PokerStars Zoom Hand #250961369932:  Hold'em No Limit ($0.01/$0.02) - 2024/06/10 19:32:37 ET
Table 'Halley' 6-max Seat #1 is the button
Seat 1: Mirajit ($10.15 in chips)
Seat 2: HumptyD ($2 in chips)
Seat 3: L3DCO ($1.66 in chips)
Seat 4: Poleza-51 ($2.09 in chips)
Seat 5: joaoabate ($1.92 in chips)
Seat 6: Quantum771 ($2 in chips)
HumptyD: posts small blind $0.01
L3DCO: posts big blind $0.02
*** HOLE CARDS ***
Dealt to HumptyD [Kd 2d]
Poleza-51: folds
joaoabate: folds
Quantum771: folds
Mirajit: raises $0.03 to $0.05
HumptyD: folds
L3DCO: raises $0.05 to $0.10
Mirajit: calls $0.05
*** FLOP *** [Ah 9d 2h]
L3DCO: bets $0.10
Mirajit: calls $0.10
*** TURN *** [Ah 9d 2h] [8s]
L3DCO: bets $0.12
Mirajit: calls $0.12
*** RIVER *** [Ah 9d 2h 8s] [9c]
L3DCO: bets $0.30
Mirajit: calls $0.30
*** SHOW DOWN ***
L3DCO: shows [Ks Qs] (a pair of Nines)
Mirajit: shows [3c Ac] (two pair, Aces and Nines)
Mirajit collected $1.21 from pot
*** SUMMARY ***
Total pot $1.25 | Rake $0.04
Board [Ah 9d 2h 8s 9c]
Seat 1: Mirajit (button) showed [3c Ac] and won ($1.21) with two pair, Aces and Nines
Seat 2: HumptyD (small blind) folded before Flop
Seat 3: L3DCO (big blind) showed [Ks Qs] and lost with a pair of Nines
Seat 4: Poleza-51 folded before Flop (didn't bet)
Seat 5: joaoabate folded before Flop (didn't bet)
Seat 6: Quantum771 folded before Flop (didn't bet)

PokerStars Zoom Hand #250961382031:  Hold'em No Limit ($0.01/$0.02) - 2024/06/10 19:33:35 ET
Table 'Halley' 6-max Seat #1 is the button
Seat 1: Leviathan74 ($2 in chips)
Seat 2: L3DCO ($1.04 in chips)
Seat 3: pcs48 ($1.88 in chips)
Seat 4: MMTI ($1.22 in chips)
Seat 5: pitboss914 ($2.46 in chips)
Seat 6: HumptyD ($2.07 in chips)
L3DCO: posts small blind $0.01
pcs48: posts big blind $0.02
*** HOLE CARDS ***
Dealt to HumptyD [9s Qs]
MMTI: calls $0.02
pitboss914: folds
HumptyD: raises $0.07 to $0.09
Leviathan74: folds
L3DCO: folds
pcs48: folds
MMTI: calls $0.07
*** FLOP *** [4h 5s 2d]
MMTI: checks
HumptyD: checks
*** TURN *** [4h 5s 2d] [3s]
MMTI: bets $0.13
HumptyD: calls $0.13
*** RIVER *** [4h 5s 2d 3s] [4c]
MMTI: bets $1 and is all-in
HumptyD: folds
Uncalled bet ($1) returned to MMTI
MMTI collected $0.45 from pot
MMTI: doesn't show hand
*** SUMMARY ***
Total pot $0.47 | Rake $0.02
Board [4h 5s 2d 3s 4c]
Seat 1: Leviathan74 (button) folded before Flop (didn't bet)
Seat 2: L3DCO (small blind) folded before Flop
Seat 3: pcs48 (big blind) folded before Flop
Seat 4: MMTI collected ($0.45)
Seat 5: pitboss914 folded before Flop (didn't bet)
Seat 6: HumptyD folded on the River

PokerStars Zoom Hand #250961392358:  Hold'em No Limit ($0.01/$0.02) - 2024/06/10 19:34:24 ET
Table 'Halley' 6-max Seat #1 is the button
Seat 1: gomita31 ($2.41 in chips)
Seat 2: RollinOlson13 ($2.68 in chips)
Seat 3: HumptyD ($2 in chips)
Seat 4: Freestyle_Bnet ($4.03 in chips)
Seat 5: jackdanius ($2 in chips)
Seat 6: small9991 ($1.77 in chips)
RollinOlson13: posts small blind $0.01
HumptyD: posts big blind $0.02
*** HOLE CARDS ***
Dealt to HumptyD [Jc Js]
Freestyle_Bnet: folds
jackdanius: folds
small9991: folds
gomita31: folds
RollinOlson13: folds
Uncalled bet ($0.01) returned to HumptyD
HumptyD collected $0.02 from pot
HumptyD: doesn't show hand
*** SUMMARY ***
Total pot $0.02 | Rake $0
Seat 1: gomita31 (button) folded before Flop (didn't bet)
Seat 2: RollinOlson13 (small blind) folded before Flop
Seat 3: HumptyD (big blind) collected ($0.02)
Seat 4: Freestyle_Bnet folded before Flop (didn't bet)
Seat 5: jackdanius folded before Flop (didn't bet)
Seat 6: small9991 folded before Flop (didn't bet)

PokerStars Zoom Hand #250961396371:  Hold'em No Limit ($0.01/$0.02) - 2024/06/10 19:34:43 ET
Table 'Halley' 6-max Seat #1 is the button
Seat 1: capuuh ($2 in chips)
Seat 2: HumptyD ($2.01 in chips)
Seat 3: guiperobelli123 ($4.11 in chips)
Seat 4: Paya_31 ($1.98 in chips)
Seat 5: lamosca51 ($1.33 in chips)
Seat 6: EminNimer ($7.43 in chips)
HumptyD: posts small blind $0.01
guiperobelli123: posts big blind $0.02
*** HOLE CARDS ***
Dealt to HumptyD [9h 2h]
Paya_31: folds
lamosca51: folds
EminNimer: raises $0.03 to $0.05
capuuh: folds
HumptyD: folds
guiperobelli123: folds
Uncalled bet ($0.03) returned to EminNimer
EminNimer collected $0.05 from pot
EminNimer: doesn't show hand
*** SUMMARY ***
Total pot $0.05 | Rake $0
Seat 1: capuuh (button) folded before Flop (didn't bet)
Seat 2: HumptyD (small blind) folded before Flop
Seat 3: guiperobelli123 (big blind) folded before Flop
Seat 4: Paya_31 folded before Flop (didn't bet)
Seat 5: lamosca51 folded before Flop (didn't bet)
Seat 6: EminNimer collected ($0.05)

PokerStars Zoom Hand #250961400011:  Hold'em No Limit ($0.01/$0.02) - 2024/06/10 19:35:00 ET
Table 'Halley' 6-max Seat #1 is the button
Seat 1: Mirajit ($10.72 in chips)
Seat 2: WhiteDeath55 ($2.01 in chips)
Seat 3: HumptyD ($2 in chips)
Seat 4: invictusfp ($3.75 in chips)
Seat 5: PITUCAV ($2.09 in chips)
Seat 6: bettanye ($2 in chips)
WhiteDeath55: posts small blind $0.01
HumptyD: posts big blind $0.02
*** HOLE CARDS ***
Dealt to HumptyD [8c Ts]
invictusfp: folds
PITUCAV: folds
bettanye: folds
Mirajit: folds
WhiteDeath55: folds
Uncalled bet ($0.01) returned to HumptyD
HumptyD collected $0.02 from pot
HumptyD: doesn't show hand
*** SUMMARY ***
Total pot $0.02 | Rake $0
Seat 1: Mirajit (button) folded before Flop (didn't bet)
Seat 2: WhiteDeath55 (small blind) folded before Flop
Seat 3: HumptyD (big blind) collected ($0.02)
Seat 4: invictusfp folded before Flop (didn't bet)
Seat 5: PITUCAV folded before Flop (didn't bet)
Seat 6: bettanye folded before Flop (didn't bet)

PokerStars Zoom Hand #250961397700:  Hold'em No Limit ($0.01/$0.02) - 2024/06/10 19:34:49 ET
Table 'Halley' 6-max Seat #1 is the button
Seat 1: mr_maxsize ($5.32 in chips)
Seat 2: pursenatcher ($1.95 in chips)
Seat 3: RafaByPoker ($2 in chips)
Seat 4: HumptyD ($2 in chips)
Seat 5: guiperobelli123 ($4.09 in chips)
Seat 6: maykolpb ($1.03 in chips)
pursenatcher: posts small blind $0.01
RafaByPoker: posts big blind $0.02
*** HOLE CARDS ***
Dealt to HumptyD [4d Td]
HumptyD: folds
guiperobelli123: raises $0.02 to $0.04
maykolpb: folds
mr_maxsize: folds
pursenatcher: calls $0.03
RafaByPoker: folds
*** FLOP *** [9s 4h 3s]
pursenatcher: checks
guiperobelli123: bets $0.05
pursenatcher: calls $0.05
*** TURN *** [9s 4h 3s] [3h]
pursenatcher: bets $0.10
guiperobelli123: folds
Uncalled bet ($0.10) returned to pursenatcher
pursenatcher collected $0.19 from pot
pursenatcher: doesn't show hand
*** SUMMARY ***
Total pot $0.20 | Rake $0.01
Board [9s 4h 3s 3h]
Seat 1: mr_maxsize (button) folded before Flop (didn't bet)
Seat 2: pursenatcher (small blind) collected ($0.19)
Seat 3: RafaByPoker (big blind) folded before Flop
Seat 4: HumptyD folded before Flop (didn't bet)
Seat 5: guiperobelli123 folded on the Turn
Seat 6: maykolpb folded before Flop (didn't bet)

PokerStars Zoom Hand #250961395287:  Hold'em No Limit ($0.01/$0.02) - 2024/06/10 19:34:38 ET
Table 'Halley' 6-max Seat #1 is the button
Seat 1: HumptyD ($2.01 in chips)
Seat 2: Freestyle_Bnet ($2.68 in chips)
Seat 3: mr_maxsize ($5.34 in chips)
Seat 4: Tenshi18 ($2 in chips)
Seat 5: Leviathan74 ($2.04 in chips)
Seat 6: descandy ($2 in chips)
Freestyle_Bnet: posts small blind $0.01
mr_maxsize: posts big blind $0.02
*** HOLE CARDS ***
Dealt to HumptyD [Jh 6s]
Tenshi18: raises $0.02 to $0.04
Leviathan74: folds
descandy: folds
HumptyD: folds
Freestyle_Bnet: calls $0.03
mr_maxsize: folds
*** FLOP *** [7d 4d 3s]
Freestyle_Bnet: checks
Tenshi18: bets $0.05
Freestyle_Bnet: calls $0.05
*** TURN *** [7d 4d 3s] [3c]
Freestyle_Bnet: checks
Tenshi18: bets $0.14
Freestyle_Bnet: calls $0.14
*** RIVER *** [7d 4d 3s 3c] [4s]
Freestyle_Bnet: bets $0.35
Tenshi18: calls $0.35
*** SHOW DOWN ***
Freestyle_Bnet: shows [4c Ac] (a full house, Fours full of Threes)
Tenshi18: mucks hand
Freestyle_Bnet collected $1.14 from pot
*** SUMMARY ***
Total pot $1.18 | Rake $0.04
Board [7d 4d 3s 3c 4s]
Seat 1: HumptyD (button) folded before Flop (didn't bet)
Seat 2: Freestyle_Bnet (small blind) showed [4c Ac] and won ($1.14) with a full house, Fours full of Threes
Seat 3: mr_maxsize (big blind) folded before Flop
Seat 4: Tenshi18 mucked [Qd Qs]
Seat 5: Leviathan74 folded before Flop (didn't bet)
Seat 6: descandy folded before Flop (didn't bet)

PokerStars Zoom Hand #250961394020:  Hold'em No Limit ($0.01/$0.02) - 2024/06/10 19:34:32 ET
Table 'Halley' 6-max Seat #1 is the button
Seat 1: pursenatcher ($1.93 in chips)
Seat 2: Rabbitsz ($2.16 in chips)
Seat 3: MtR_CoNaN ($3.18 in chips)
Seat 4: iwakoba ($2 in chips)
Seat 5: HumptyD ($2.01 in chips)
Seat 6: Leviathan74 ($2.06 in chips)
Rabbitsz: posts small blind $0.01
MtR_CoNaN: posts big blind $0.02
*** HOLE CARDS ***
Dealt to HumptyD [7h 4d]
iwakoba: raises $0.02 to $0.04
HumptyD: folds
Leviathan74: folds
pursenatcher: folds
Rabbitsz: folds
MtR_CoNaN: calls $0.02
*** FLOP *** [Qc Jd Ks]
MtR_CoNaN: checks
iwakoba: bets $0.03
MtR_CoNaN: calls $0.03
*** TURN *** [Qc Jd Ks] [6s]
MtR_CoNaN: checks
iwakoba: bets $0.11
MtR_CoNaN: calls $0.11
*** RIVER *** [Qc Jd Ks 6s] [Kd]
MtR_CoNaN: checks
iwakoba: bets $0.40
MtR_CoNaN: calls $0.40
*** SHOW DOWN ***
iwakoba: shows [5s 5c] (two pair, Kings and Fives)
MtR_CoNaN: shows [Ac Qh] (two pair, Kings and Queens)
MtR_CoNaN collected $1.13 from pot
*** SUMMARY ***
Total pot $1.17 | Rake $0.04
Board [Qc Jd Ks 6s Kd]
Seat 1: pursenatcher (button) folded before Flop (didn't bet)
Seat 2: Rabbitsz (small blind) folded before Flop
Seat 3: MtR_CoNaN (big blind) showed [Ac Qh] and won ($1.13) with two pair, Kings and Queens
Seat 4: iwakoba showed [5s 5c] and lost with two pair, Kings and Fives
Seat 5: HumptyD folded before Flop (didn't bet)
Seat 6: Leviathan74 folded before Flop (didn't bet)

PokerStars Zoom Hand #250961398516:  Hold'em No Limit ($0.01/$0.02) - 2024/06/10 19:34:53 ET
Table 'Halley' 6-max Seat #1 is the button
Seat 1: Amazonia2010 ($2.03 in chips)
Seat 2: Keltu :D ($3.41 in chips)
Seat 3: MMTI ($1.43 in chips)
Seat 4: EminNimer ($7.46 in chips)
Seat 5: algorithmk9999 ($2.02 in chips)
Seat 6: HumptyD ($2 in chips)
Keltu :D: posts small blind $0.01
MMTI: posts big blind $0.02
*** HOLE CARDS ***
Dealt to HumptyD [7s 4s]
EminNimer: folds
algorithmk9999: raises $0.04 to $0.06
HumptyD: folds
Amazonia2010: folds
Keltu :D: folds
MMTI: calls $0.04
*** FLOP *** [Jc Tc Qd]
MMTI: checks
algorithmk9999: bets $0.07
MMTI: calls $0.07
*** TURN *** [Jc Tc Qd] [5s]
MMTI: checks
algorithmk9999: checks
*** RIVER *** [Jc Tc Qd 5s] [5d]
MMTI: bets $1.30 and is all-in
algorithmk9999: folds
Uncalled bet ($1.30) returned to MMTI
MMTI collected $0.26 from pot
MMTI: doesn't show hand
*** SUMMARY ***
Total pot $0.27 | Rake $0.01
Board [Jc Tc Qd 5s 5d]
Seat 1: Amazonia2010 (button) folded before Flop (didn't bet)
Seat 2: Keltu :D (small blind) folded before Flop
Seat 3: MMTI (big blind) collected ($0.26)
Seat 4: EminNimer folded before Flop (didn't bet)
Seat 5: algorithmk9999 folded on the River
Seat 6: HumptyD folded before Flop (didn't bet)

PokerStars Zoom Hand #250961402000:  Hold'em No Limit ($0.01/$0.02) - 2024/06/10 19:35:09 ET
Table 'Halley' 6-max Seat #1 is the button
Seat 1: R!usonken ($2.66 in chips)
Seat 2: Amazonia2010 ($2.01 in chips)
Seat 3: brenopmo ($2 in chips)
Seat 4: alsec93 ($5.10 in chips)
Seat 5: HumptyD ($2.01 in chips)
Seat 6: bettanye ($2 in chips)
Amazonia2010: posts small blind $0.01
brenopmo: posts big blind $0.02
*** HOLE CARDS ***
Dealt to HumptyD [Js Jd]
alsec93: folds
HumptyD: raises $0.04 to $0.06
bettanye: folds
R!usonken: raises $0.13 to $0.19
Amazonia2010: folds
brenopmo: folds
HumptyD: calls $0.13
*** FLOP *** [6d Td Ac]
HumptyD: checks
R!usonken: bets $0.13
HumptyD: calls $0.13
*** TURN *** [6d Td Ac] [4h]
HumptyD: checks
R!usonken: bets $0.49
HumptyD: folds
Uncalled bet ($0.49) returned to R!usonken
R!usonken collected $0.65 from pot
R!usonken: doesn't show hand
*** SUMMARY ***
Total pot $0.67 | Rake $0.02
Board [6d Td Ac 4h]
Seat 1: R!usonken (button) collected ($0.65)
Seat 2: Amazonia2010 (small blind) folded before Flop
Seat 3: brenopmo (big blind) folded before Flop
Seat 4: alsec93 folded before Flop (didn't bet)
Seat 5: HumptyD folded on the Turn
Seat 6: bettanye folded before Flop (didn't bet)

PokerStars Zoom Hand #250961414374:  Hold'em No Limit ($0.01/$0.02) - 2024/06/10 19:36:07 ET
Table 'Halley' 6-max Seat #1 is the button
Seat 1: pumpkidd ($2.26 in chips)
Seat 2: mr_maxsize ($3.29 in chips)
Seat 3: Peebo-Nard ($11.02 in chips)
Seat 4: HumptyD ($2 in chips)
Seat 5: MJ_Barboza ($2 in chips)
Seat 6: Mirajit ($8.44 in chips)
mr_maxsize: posts small blind $0.01
Peebo-Nard: posts big blind $0.02
*** HOLE CARDS ***
Dealt to HumptyD [Jh Tc]
HumptyD: raises $0.04 to $0.06
MJ_Barboza: folds
Mirajit: folds
pumpkidd: calls $0.06
mr_maxsize: folds
Peebo-Nard: folds
*** FLOP *** [Kd Td 3h]
HumptyD: checks
pumpkidd: bets $0.05
HumptyD: calls $0.05
*** TURN *** [Kd Td 3h] [6d]
HumptyD: checks
pumpkidd: checks
*** RIVER *** [Kd Td 3h 6d] [6h]
HumptyD: checks
pumpkidd: checks
*** SHOW DOWN ***
HumptyD: shows [Jh Tc] (two pair, Tens and Sixes)
pumpkidd: mucks hand
HumptyD collected $0.24 from pot
*** SUMMARY ***
Total pot $0.25 | Rake $0.01
Board [Kd Td 3h 6d 6h]
Seat 1: pumpkidd (button) mucked [Qs Js]
Seat 2: mr_maxsize (small blind) folded before Flop
Seat 3: Peebo-Nard (big blind) folded before Flop
Seat 4: HumptyD showed [Jh Tc] and won ($0.24) with two pair, Tens and Sixes
Seat 5: MJ_Barboza folded before Flop (didn't bet)
Seat 6: Mirajit folded before Flop (didn't bet)

PokerStars Zoom Hand #250961426271:  Hold'em No Limit ($0.01/$0.02) - 2024/06/10 19:37:03 ET
Table 'Halley' 6-max Seat #1 is the button
Seat 1: chudyand1 ($2.11 in chips)
Seat 2: HumptyD ($2.13 in chips)
Seat 3: TamiSieche ($3.95 in chips)
Seat 4: pursenatcher ($2.48 in chips)
Seat 5: kremator29 ($1.06 in chips)
Seat 6: MtR_CoNaN ($3.04 in chips)
HumptyD: posts small blind $0.01
TamiSieche: posts big blind $0.02
*** HOLE CARDS ***
Dealt to HumptyD [3s 2c]
pursenatcher: folds
kremator29: folds
MtR_CoNaN: folds
chudyand1: folds
HumptyD: folds
Uncalled bet ($0.01) returned to TamiSieche
TamiSieche collected $0.02 from pot
TamiSieche: doesn't show hand
*** SUMMARY ***
Total pot $0.02 | Rake $0
Seat 1: chudyand1 (button) folded before Flop (didn't bet)
Seat 2: HumptyD (small blind) folded before Flop
Seat 3: TamiSieche (big blind) collected ($0.02)
Seat 4: pursenatcher folded before Flop (didn't bet)
Seat 5: kremator29 folded before Flop (didn't bet)
Seat 6: MtR_CoNaN folded before Flop (didn't bet)

PokerStars Zoom Hand #250961430109:  Hold'em No Limit ($0.01/$0.02) - 2024/06/10 19:37:21 ET
Table 'Halley' 6-max Seat #1 is the button
Seat 1: HumptyD ($2.12 in chips)
Seat 2: joaoabate ($1.86 in chips)
Seat 3: mr_maxsize ($2.06 in chips)
Seat 4: jackdanius ($2.06 in chips)
Seat 5: backgamer10 ($1.20 in chips)
Seat 6: pumpkidd ($2.14 in chips)
joaoabate: posts small blind $0.01
mr_maxsize: posts big blind $0.02
*** HOLE CARDS ***
Dealt to HumptyD [5d Qh]
jackdanius: folds
backgamer10: folds
pumpkidd: raises $0.04 to $0.06
HumptyD: folds
joaoabate: folds
mr_maxsize: folds
Uncalled bet ($0.04) returned to pumpkidd
pumpkidd collected $0.05 from pot
pumpkidd: doesn't show hand
*** SUMMARY ***
Total pot $0.05 | Rake $0
Seat 1: HumptyD (button) folded before Flop (didn't bet)
Seat 2: joaoabate (small blind) folded before Flop
Seat 3: mr_maxsize (big blind) folded before Flop
Seat 4: jackdanius folded before Flop (didn't bet)
Seat 5: backgamer10 folded before Flop (didn't bet)
Seat 6: pumpkidd collected ($0.05)

PokerStars Zoom Hand #250961431343:  Hold'em No Limit ($0.01/$0.02) - 2024/06/10 19:37:27 ET
Table 'Halley' 6-max Seat #1 is the button
Seat 1: FFForasteiro ($2.02 in chips)
Seat 2: kremator29 ($1.06 in chips)
Seat 3: alnic11 ($1.46 in chips)
Seat 4: HumptyD ($2.12 in chips)
Seat 5: R!usonken ($2.93 in chips)
Seat 6: Keltu :D ($3.56 in chips)
kremator29: posts small blind $0.01
alnic11: posts big blind $0.02
*** HOLE CARDS ***
Dealt to HumptyD [7s 8c]
HumptyD: folds
R!usonken: raises $0.02 to $0.04
Keltu :D: folds
FFForasteiro: folds
kremator29: folds
alnic11: folds
Uncalled bet ($0.02) returned to R!usonken
R!usonken collected $0.05 from pot
R!usonken: doesn't show hand
*** SUMMARY ***
Total pot $0.05 | Rake $0
Seat 1: FFForasteiro (button) folded before Flop (didn't bet)
Seat 2: kremator29 (small blind) folded before Flop
Seat 3: alnic11 (big blind) folded before Flop
Seat 4: HumptyD folded before Flop (didn't bet)
Seat 5: R!usonken collected ($0.05)
Seat 6: Keltu :D folded before Flop (didn't bet)

PokerStars Zoom Hand #250961432702:  Hold'em No Limit ($0.01/$0.02) - 2024/06/10 19:37:33 ET
Table 'Halley' 6-max Seat #1 is the button
Seat 1: coolDadJimbo ($7.17 in chips)
Seat 2: gilberto98 ($1.86 in chips)
Seat 3: Invron11 ($3.73 in chips)
Seat 4: hugoreisssss ($2.12 in chips)
Seat 5: Johnis111 ($4.16 in chips)
Seat 6: HumptyD ($2.12 in chips)
gilberto98: posts small blind $0.01
Invron11: posts big blind $0.02
*** HOLE CARDS ***
Dealt to HumptyD [5d Td]
hugoreisssss: folds
Johnis111: folds
HumptyD: folds
coolDadJimbo: folds
gilberto98: raises $0.02 to $0.04
Invron11: folds
Uncalled bet ($0.02) returned to gilberto98
gilberto98 collected $0.04 from pot
gilberto98: doesn't show hand
*** SUMMARY ***
Total pot $0.04 | Rake $0
Seat 1: coolDadJimbo (button) folded before Flop (didn't bet)
Seat 2: gilberto98 (small blind) collected ($0.04)
Seat 3: Invron11 (big blind) folded before Flop
Seat 4: hugoreisssss folded before Flop (didn't bet)
Seat 5: Johnis111 folded before Flop (didn't bet)
Seat 6: HumptyD folded before Flop (didn't bet)

PokerStars Zoom Hand #250961434590:  Hold'em No Limit ($0.01/$0.02) - 2024/06/10 19:37:42 ET
Table 'Halley' 6-max Seat #1 is the button
Seat 1: Misterfreezejo ($2.10 in chips)
Seat 2: slidepop ($2.56 in chips)
Seat 3: HumptyD ($2.12 in chips)
Seat 4: bryld2 ($2.02 in chips)
Seat 5: -analisante- ($2.22 in chips)
Seat 6: R!usonken ($3.72 in chips)
slidepop: posts small blind $0.01
HumptyD: posts big blind $0.02
*** HOLE CARDS ***
Dealt to HumptyD [3s 5c]
bryld2: folds
-analisante-: folds
R!usonken: raises $0.03 to $0.05
Misterfreezejo: folds
slidepop: folds
HumptyD: folds
Uncalled bet ($0.03) returned to R!usonken
R!usonken collected $0.05 from pot
R!usonken: doesn't show hand
*** SUMMARY ***
Total pot $0.05 | Rake $0
Seat 1: Misterfreezejo (button) folded before Flop (didn't bet)
Seat 2: slidepop (small blind) folded before Flop
Seat 3: HumptyD (big blind) folded before Flop
Seat 4: bryld2 folded before Flop (didn't bet)
Seat 5: -analisante- folded before Flop (didn't bet)
Seat 6: R!usonken collected ($0.05)

PokerStars Zoom Hand #250961437105:  Hold'em No Limit ($0.01/$0.02) - 2024/06/10 19:37:54 ET
Table 'Halley' 6-max Seat #1 is the button
Seat 1: HumptyD ($2.10 in chips)
Seat 2: Leviathan74 ($1.88 in chips)
Seat 3: lewisweight ($3.55 in chips)
Seat 4: IanMacDaddy ($3.03 in chips)
Seat 5: pursenatcher ($1.82 in chips)
Seat 6: praznina ($2.77 in chips)
Leviathan74: posts small blind $0.01
lewisweight: posts big blind $0.02
*** HOLE CARDS ***
Dealt to HumptyD [Jh 5h]
IanMacDaddy: folds
pursenatcher: raises $0.02 to $0.04
praznina: folds
HumptyD: folds
Leviathan74: folds
lewisweight: folds
Uncalled bet ($0.02) returned to pursenatcher
pursenatcher collected $0.05 from pot
pursenatcher: doesn't show hand
*** SUMMARY ***
Total pot $0.05 | Rake $0
Seat 1: HumptyD (button) folded before Flop (didn't bet)
Seat 2: Leviathan74 (small blind) folded before Flop
Seat 3: lewisweight (big blind) folded before Flop
Seat 4: IanMacDaddy folded before Flop (didn't bet)
Seat 5: pursenatcher collected ($0.05)
Seat 6: praznina folded before Flop (didn't bet)

PokerStars Zoom Hand #250961439879:  Hold'em No Limit ($0.01/$0.02) - 2024/06/10 19:38:07 ET
Table 'Halley' 6-max Seat #1 is the button
Seat 1: FFForasteiro ($2 in chips)
Seat 2: descandy ($2.09 in chips)
Seat 3: Fukudasai ($2.02 in chips)
Seat 4: slidepop ($3.67 in chips)
Seat 5: HumptyD ($2.10 in chips)
Seat 6: pursenatcher ($2.58 in chips)
descandy: posts small blind $0.01
Fukudasai: posts big blind $0.02
*** HOLE CARDS ***
Dealt to HumptyD [6s 8h]
slidepop: folds
HumptyD: folds
pursenatcher: folds
FFForasteiro: raises $0.03 to $0.05
descandy: folds
Fukudasai: calls $0.03
*** FLOP *** [Ac Jc 6c]
Fukudasai: checks
FFForasteiro: bets $0.06
Fukudasai: folds
Uncalled bet ($0.06) returned to FFForasteiro
FFForasteiro collected $0.11 from pot
FFForasteiro: doesn't show hand
*** SUMMARY ***
Total pot $0.11 | Rake $0
Board [Ac Jc 6c]
Seat 1: FFForasteiro (button) collected ($0.11)
Seat 2: descandy (small blind) folded before Flop
Seat 3: Fukudasai (big blind) folded on the Flop
Seat 4: slidepop folded before Flop (didn't bet)
Seat 5: HumptyD folded before Flop (didn't bet)
Seat 6: pursenatcher folded before Flop (didn't bet)

PokerStars Zoom Hand #250961441346:  Hold'em No Limit ($0.01/$0.02) - 2024/06/10 19:38:14 ET
Table 'Halley' 6-max Seat #1 is the button
Seat 1: S@LTY"CTM" ($1 in chips)
Seat 2: HumptyD ($2.10 in chips)
Seat 3: alsec93 ($5.22 in chips)
Seat 4: Invron11 ($2.03 in chips)
Seat 5: gomusin ($3.88 in chips)
Seat 6: pursenatcher ($1.44 in chips)
HumptyD: posts small blind $0.01
alsec93: posts big blind $0.02
*** HOLE CARDS ***
Dealt to HumptyD [Kc Ts]
Invron11: folds
gomusin: folds
pursenatcher: folds
S@LTY"CTM": folds
HumptyD: raises $0.04 to $0.06
alsec93: raises $0.18 to $0.24
HumptyD: calls $0.18
*** FLOP *** [8s 5s Ad]
HumptyD: checks
alsec93: bets $0.16
HumptyD: folds
Uncalled bet ($0.16) returned to alsec93
alsec93 collected $0.46 from pot
alsec93: doesn't show hand
*** SUMMARY ***
Total pot $0.48 | Rake $0.02
Board [8s 5s Ad]
Seat 1: S@LTY"CTM" (button) folded before Flop (didn't bet)
Seat 2: HumptyD (small blind) folded on the Flop
Seat 3: alsec93 (big blind) collected ($0.46)
Seat 4: Invron11 folded before Flop (didn't bet)
Seat 5: gomusin folded before Flop (didn't bet)
Seat 6: pursenatcher folded before Flop (didn't bet)


Hand ID: 4

PokerStars Hand #251180667486: Tournament #3770707316, $0.46+$0.04 USD Hold'em No Limit - Level I (10/20) - 2024/06/24 20:14:14 ET
Table '3770707316 1' 3-max Seat #1 is the button
Seat 1: HumptyD (500 in chips)
Seat 2: armandstefan20 (500 in chips)
Seat 3: MARGINALBH (500 in chips)
armandstefan20: posts small blind 10
MARGINALBH: posts big blind 20
*** HOLE CARDS ***
Dealt to HumptyD [5h Ah]
HumptyD: raises 20 to 40
armandstefan20: calls 30
MARGINALBH: folds
*** FLOP *** [7s 3s 4c]
armandstefan20: checks
HumptyD: checks
*** TURN *** [7s 3s 4c] [7c]
armandstefan20: bets 50
HumptyD: folds
Uncalled bet (50) returned to armandstefan20
armandstefan20 collected 100 from pot
*** SUMMARY ***
Total pot 100 | Rake 0
Board [7s 3s 4c 7c]
Seat 1: HumptyD (button) folded on the Turn
Seat 2: armandstefan20 (small blind) collected (100)
Seat 3: MARGINALBH (big blind) folded before Flop

PokerStars Hand #251180678411: Tournament #3770707316, $0.46+$0.04 USD Hold'em No Limit - Level I (10/20) - 2024/06/24 20:15:16 ET
Table '3770707316 1' 3-max Seat #2 is the button
Seat 1: HumptyD (460 in chips)
Seat 2: armandstefan20 (560 in chips)
Seat 3: MARGINALBH (480 in chips)
MARGINALBH: posts small blind 10
HumptyD: posts big blind 20
*** HOLE CARDS ***
Dealt to HumptyD [Qh 2h]
armandstefan20: raises 40 to 60
MARGINALBH: folds
HumptyD: folds
Uncalled bet (40) returned to armandstefan20
armandstefan20 collected 50 from pot
*** SUMMARY ***
Total pot 50 | Rake 0
Seat 1: HumptyD (big blind) folded before Flop
Seat 2: armandstefan20 (button) collected (50)
Seat 3: MARGINALBH (small blind) folded before Flop

PokerStars Hand #251180681486: Tournament #3770707316, $0.46+$0.04 USD Hold'em No Limit - Level I (10/20) - 2024/06/24 20:15:33 ET
Table '3770707316 1' 3-max Seat #3 is the button
Seat 1: HumptyD (440 in chips)
Seat 2: armandstefan20 (590 in chips)
Seat 3: MARGINALBH (470 in chips)
HumptyD: posts small blind 10
armandstefan20: posts big blind 20
*** HOLE CARDS ***
Dealt to HumptyD [9c As]
MARGINALBH has timed out
MARGINALBH: folds
MARGINALBH is sitting out
HumptyD: calls 10
armandstefan20: checks
*** FLOP *** [Ts Ac 5d]
MARGINALBH has returned
HumptyD: checks
armandstefan20: checks
*** TURN *** [Ts Ac 5d] [3c]
HumptyD: checks
armandstefan20: checks
*** RIVER *** [Ts Ac 5d 3c] [4s]
HumptyD: checks
armandstefan20: checks
*** SHOW DOWN ***
HumptyD: shows [9c As] (a pair of Aces)
armandstefan20: mucks hand
HumptyD collected 40 from pot
*** SUMMARY ***
Total pot 40 | Rake 0
Board [Ts Ac 5d 3c 4s]
Seat 1: HumptyD (small blind) showed [9c As] and won (40) with a pair of Aces
Seat 2: armandstefan20 (big blind) mucked [6d Qd]
Seat 3: MARGINALBH (button) folded before Flop (didn't bet)

PokerStars Hand #251180689457: Tournament #3770707316, $0.46+$0.04 USD Hold'em No Limit - Level I (10/20) - 2024/06/24 20:16:18 ET
Table '3770707316 1' 3-max Seat #1 is the button
Seat 1: HumptyD (460 in chips)
Seat 2: armandstefan20 (570 in chips)
Seat 3: MARGINALBH (470 in chips)
armandstefan20: posts small blind 10
MARGINALBH: posts big blind 20
*** HOLE CARDS ***
Dealt to HumptyD [8c 4s]
HumptyD: folds
armandstefan20: raises 40 to 60
MARGINALBH: calls 40
*** FLOP *** [5s 6h Th]
armandstefan20: checks
MARGINALBH: checks
*** TURN *** [5s 6h Th] [6c]
armandstefan20: bets 60
MARGINALBH: folds
Uncalled bet (60) returned to armandstefan20
armandstefan20 collected 120 from pot
*** SUMMARY ***
Total pot 120 | Rake 0
Board [5s 6h Th 6c]
Seat 1: HumptyD (button) folded before Flop (didn't bet)
Seat 2: armandstefan20 (small blind) collected (120)
Seat 3: MARGINALBH (big blind) folded on the Turn

PokerStars Hand #251180692521: Tournament #3770707316, $0.46+$0.04 USD Hold'em No Limit - Level I (10/20) - 2024/06/24 20:16:36 ET
Table '3770707316 1' 3-max Seat #2 is the button
Seat 1: HumptyD (460 in chips)
Seat 2: armandstefan20 (630 in chips)
Seat 3: MARGINALBH (410 in chips)
MARGINALBH: posts small blind 10
HumptyD: posts big blind 20
*** HOLE CARDS ***
Dealt to HumptyD [Ad 2h]
armandstefan20: folds
MARGINALBH: raises 20 to 40
HumptyD: raises 420 to 460 and is all-in
MARGINALBH: folds
Uncalled bet (420) returned to HumptyD
HumptyD collected 80 from pot
HumptyD: doesn't show hand
*** SUMMARY ***
Total pot 80 | Rake 0
Seat 1: HumptyD (big blind) collected (80)
Seat 2: armandstefan20 (button) folded before Flop (didn't bet)
Seat 3: MARGINALBH (small blind) folded before Flop

PokerStars Hand #251180696822: Tournament #3770707316, $0.46+$0.04 USD Hold'em No Limit - Level I (10/20) - 2024/06/24 20:17:00 ET
Table '3770707316 1' 3-max Seat #3 is the button
Seat 1: HumptyD (500 in chips)
Seat 2: armandstefan20 (630 in chips)
Seat 3: MARGINALBH (370 in chips)
HumptyD: posts small blind 10
armandstefan20: posts big blind 20
*** HOLE CARDS ***
Dealt to HumptyD [3h 8d]
MARGINALBH: raises 350 to 370 and is all-in
HumptyD: folds
armandstefan20: folds
Uncalled bet (350) returned to MARGINALBH
MARGINALBH collected 50 from pot
*** SUMMARY ***
Total pot 50 | Rake 0
Seat 1: HumptyD (small blind) folded before Flop
Seat 2: armandstefan20 (big blind) folded before Flop
Seat 3: MARGINALBH (button) collected (50)

PokerStars Hand #251180698507: Tournament #3770707316, $0.46+$0.04 USD Hold'em No Limit - Level I (10/20) - 2024/06/24 20:17:10 ET
Table '3770707316 1' 3-max Seat #1 is the button
Seat 1: HumptyD (490 in chips)
Seat 2: armandstefan20 (610 in chips)
Seat 3: MARGINALBH (400 in chips)
armandstefan20: posts small blind 10
MARGINALBH: posts big blind 20
*** HOLE CARDS ***
Dealt to HumptyD [2c 5h]
HumptyD: folds
armandstefan20: folds
Uncalled bet (10) returned to MARGINALBH
MARGINALBH collected 20 from pot
*** SUMMARY ***
Total pot 20 | Rake 0
Seat 1: HumptyD (button) folded before Flop (didn't bet)
Seat 2: armandstefan20 (small blind) folded before Flop
Seat 3: MARGINALBH (big blind) collected (20)

PokerStars Hand #251180700200: Tournament #3770707316, $0.46+$0.04 USD Hold'em No Limit - Level II (15/30) - 2024/06/24 20:17:19 ET
Table '3770707316 1' 3-max Seat #2 is the button
Seat 1: HumptyD (490 in chips)
Seat 2: armandstefan20 (600 in chips)
Seat 3: MARGINALBH (410 in chips)
MARGINALBH: posts small blind 15
HumptyD: posts big blind 30
*** HOLE CARDS ***
Dealt to HumptyD [Kc 7c]
armandstefan20: raises 30 to 60
MARGINALBH: calls 45
HumptyD: folds
*** FLOP *** [Td 5d Th]
MARGINALBH: bets 150
armandstefan20: calls 150
*** TURN *** [Td 5d Th] [6d]
MARGINALBH: bets 200 and is all-in
armandstefan20: calls 200
*** RIVER *** [Td 5d Th 6d] [As]
*** SHOW DOWN ***
MARGINALBH: shows [8d Qd] (a flush, Queen high)
armandstefan20: shows [9c 9s] (two pair, Tens and Nines)
MARGINALBH collected 850 from pot
*** SUMMARY ***
Total pot 850 | Rake 0
Board [Td 5d Th 6d As]
Seat 1: HumptyD (big blind) folded before Flop
Seat 2: armandstefan20 (button) showed [9c 9s] and lost with two pair, Tens and Nines
Seat 3: MARGINALBH (small blind) showed [8d Qd] and won (850) with a flush, Queen high

PokerStars Hand #251180705284: Tournament #3770707316, $0.46+$0.04 USD Hold'em No Limit - Level II (15/30) - 2024/06/24 20:17:49 ET
Table '3770707316 1' 3-max Seat #3 is the button
Seat 1: HumptyD (460 in chips)
Seat 2: armandstefan20 (190 in chips)
Seat 3: MARGINALBH (850 in chips)
HumptyD: posts small blind 15
armandstefan20: posts big blind 30
*** HOLE CARDS ***
Dealt to HumptyD [Ad Tc]
MARGINALBH: folds
HumptyD: raises 430 to 460 and is all-in
armandstefan20: folds
Uncalled bet (430) returned to HumptyD
HumptyD collected 60 from pot
HumptyD: doesn't show hand
*** SUMMARY ***
Total pot 60 | Rake 0
Seat 1: HumptyD (small blind) collected (60)
Seat 2: armandstefan20 (big blind) folded before Flop
Seat 3: MARGINALBH (button) folded before Flop (didn't bet)

PokerStars Hand #251180707989: Tournament #3770707316, $0.46+$0.04 USD Hold'em No Limit - Level II (15/30) - 2024/06/24 20:18:04 ET
Table '3770707316 1' 3-max Seat #1 is the button
Seat 1: HumptyD (490 in chips)
Seat 2: armandstefan20 (160 in chips)
Seat 3: MARGINALBH (850 in chips)
armandstefan20: posts small blind 15
MARGINALBH: posts big blind 30
*** HOLE CARDS ***
Dealt to HumptyD [Kd Js]
HumptyD: raises 30 to 60
armandstefan20: raises 100 to 160 and is all-in
MARGINALBH: folds
HumptyD: calls 100
*** FLOP *** [8c 7c 3s]
*** TURN *** [8c 7c 3s] [4c]
*** RIVER *** [8c 7c 3s 4c] [Jh]
*** SHOW DOWN ***
armandstefan20: shows [Kh Qh] (high card King)
HumptyD: shows [Kd Js] (a pair of Jacks)
HumptyD collected 350 from pot
armandstefan20 finished the tournament in 3rd place
*** SUMMARY ***
Total pot 350 | Rake 0
Board [8c 7c 3s 4c Jh]
Seat 1: HumptyD (button) showed [Kd Js] and won (350) with a pair of Jacks
Seat 2: armandstefan20 (small blind) showed [Kh Qh] and lost with high card King
Seat 3: MARGINALBH (big blind) folded before Flop

PokerStars Hand #251180714234: Tournament #3770707316, $0.46+$0.04 USD Hold'em No Limit - Level II (15/30) - 2024/06/24 20:18:40 ET
Table '3770707316 1' 3-max Seat #3 is the button
Seat 1: HumptyD (680 in chips)
Seat 3: MARGINALBH (820 in chips)
MARGINALBH: posts small blind 15
HumptyD: posts big blind 30
*** HOLE CARDS ***
Dealt to HumptyD [Ad As]
MARGINALBH: calls 15
HumptyD: raises 60 to 90
MARGINALBH: folds
Uncalled bet (60) returned to HumptyD
HumptyD collected 60 from pot
HumptyD: doesn't show hand
*** SUMMARY ***
Total pot 60 | Rake 0
Seat 1: HumptyD (big blind) collected (60)
Seat 3: MARGINALBH (button) (small blind) folded before Flop

PokerStars Hand #251180717447: Tournament #3770707316, $0.46+$0.04 USD Hold'em No Limit - Level II (15/30) - 2024/06/24 20:18:58 ET
Table '3770707316 1' 3-max Seat #1 is the button
Seat 1: HumptyD (710 in chips)
Seat 3: MARGINALBH (790 in chips)
HumptyD: posts small blind 15
MARGINALBH: posts big blind 30
*** HOLE CARDS ***
Dealt to HumptyD [Jh 2c]
HumptyD: folds
Uncalled bet (15) returned to MARGINALBH
MARGINALBH collected 30 from pot
*** SUMMARY ***
Total pot 30 | Rake 0
Seat 1: HumptyD (button) (small blind) folded before Flop
Seat 3: MARGINALBH (big blind) collected (30)

PokerStars Hand #251180718164: Tournament #3770707316, $0.46+$0.04 USD Hold'em No Limit - Level II (15/30) - 2024/06/24 20:19:02 ET
Table '3770707316 1' 3-max Seat #3 is the button
Seat 1: HumptyD (695 in chips)
Seat 3: MARGINALBH (805 in chips)
MARGINALBH: posts small blind 15
HumptyD: posts big blind 30
*** HOLE CARDS ***
Dealt to HumptyD [Jc 8h]
MARGINALBH: raises 30 to 60
HumptyD: folds
Uncalled bet (30) returned to MARGINALBH
MARGINALBH collected 60 from pot
*** SUMMARY ***
Total pot 60 | Rake 0
Seat 1: HumptyD (big blind) folded before Flop
Seat 3: MARGINALBH (button) (small blind) collected (60)

PokerStars Hand #251180719479: Tournament #3770707316, $0.46+$0.04 USD Hold'em No Limit - Level II (15/30) - 2024/06/24 20:19:10 ET
Table '3770707316 1' 3-max Seat #1 is the button
Seat 1: HumptyD (665 in chips)
Seat 3: MARGINALBH (835 in chips)
HumptyD: posts small blind 15
MARGINALBH: posts big blind 30
*** HOLE CARDS ***
Dealt to HumptyD [9s Ts]
HumptyD: raises 30 to 60
MARGINALBH: calls 30
*** FLOP *** [7d 8s Qc]
MARGINALBH: checks
HumptyD: bets 60
MARGINALBH: folds
Uncalled bet (60) returned to HumptyD
HumptyD collected 120 from pot
HumptyD: doesn't show hand
*** SUMMARY ***
Total pot 120 | Rake 0
Board [7d 8s Qc]
Seat 1: HumptyD (button) (small blind) collected (120)
Seat 3: MARGINALBH (big blind) folded on the Flop

PokerStars Hand #251180722140: Tournament #3770707316, $0.46+$0.04 USD Hold'em No Limit - Level II (15/30) - 2024/06/24 20:19:25 ET
Table '3770707316 1' 3-max Seat #3 is the button
Seat 1: HumptyD (725 in chips)
Seat 3: MARGINALBH (775 in chips)
MARGINALBH: posts small blind 15
HumptyD: posts big blind 30
*** HOLE CARDS ***
Dealt to HumptyD [Ts 5s]
MARGINALBH: raises 30 to 60
HumptyD: folds
Uncalled bet (30) returned to MARGINALBH
MARGINALBH collected 60 from pot
*** SUMMARY ***
Total pot 60 | Rake 0
Seat 1: HumptyD (big blind) folded before Flop
Seat 3: MARGINALBH (button) (small blind) collected (60)

PokerStars Hand #251180724022: Tournament #3770707316, $0.46+$0.04 USD Hold'em No Limit - Level II (15/30) - 2024/06/24 20:19:36 ET
Table '3770707316 1' 3-max Seat #1 is the button
Seat 1: HumptyD (695 in chips)
Seat 3: MARGINALBH (805 in chips)
HumptyD: posts small blind 15
MARGINALBH: posts big blind 30
*** HOLE CARDS ***
Dealt to HumptyD [8c 3s]
HumptyD: folds
Uncalled bet (15) returned to MARGINALBH
MARGINALBH collected 30 from pot
*** SUMMARY ***
Total pot 30 | Rake 0
Seat 1: HumptyD (button) (small blind) folded before Flop
Seat 3: MARGINALBH (big blind) collected (30)

PokerStars Hand #251180724766: Tournament #3770707316, $0.46+$0.04 USD Hold'em No Limit - Level II (15/30) - 2024/06/24 20:19:41 ET
Table '3770707316 1' 3-max Seat #3 is the button
Seat 1: HumptyD (680 in chips)
Seat 3: MARGINALBH (820 in chips)
MARGINALBH: posts small blind 15
HumptyD: posts big blind 30
*** HOLE CARDS ***
Dealt to HumptyD [5h Th]
MARGINALBH: folds
Uncalled bet (15) returned to HumptyD
HumptyD collected 30 from pot
HumptyD: doesn't show hand
*** SUMMARY ***
Total pot 30 | Rake 0
Seat 1: HumptyD (big blind) collected (30)
Seat 3: MARGINALBH (button) (small blind) folded before Flop

PokerStars Hand #251180726611: Tournament #3770707316, $0.46+$0.04 USD Hold'em No Limit - Level II (15/30) - 2024/06/24 20:19:51 ET
Table '3770707316 1' 3-max Seat #1 is the button
Seat 1: HumptyD (695 in chips)
Seat 3: MARGINALBH (805 in chips)
HumptyD: posts small blind 15
MARGINALBH: posts big blind 30
*** HOLE CARDS ***
Dealt to HumptyD [5h 8d]
HumptyD: folds
Uncalled bet (15) returned to MARGINALBH
MARGINALBH collected 30 from pot
*** SUMMARY ***
Total pot 30 | Rake 0
Seat 1: HumptyD (button) (small blind) folded before Flop
Seat 3: MARGINALBH (big blind) collected (30)

PokerStars Hand #251180727482: Tournament #3770707316, $0.46+$0.04 USD Hold'em No Limit - Level II (15/30) - 2024/06/24 20:19:56 ET
Table '3770707316 1' 3-max Seat #3 is the button
Seat 1: HumptyD (680 in chips)
Seat 3: MARGINALBH (820 in chips)
MARGINALBH: posts small blind 15
HumptyD: posts big blind 30
*** HOLE CARDS ***
Dealt to HumptyD [6h Jh]
MARGINALBH: raises 30 to 60
HumptyD: folds
Uncalled bet (30) returned to MARGINALBH
MARGINALBH collected 60 from pot
*** SUMMARY ***
Total pot 60 | Rake 0
Seat 1: HumptyD (big blind) folded before Flop
Seat 3: MARGINALBH (button) (small blind) collected (60)

PokerStars Hand #251180729331: Tournament #3770707316, $0.46+$0.04 USD Hold'em No Limit - Level II (15/30) - 2024/06/24 20:20:07 ET
Table '3770707316 1' 3-max Seat #1 is the button
Seat 1: HumptyD (650 in chips)
Seat 3: MARGINALBH (850 in chips)
HumptyD: posts small blind 15
MARGINALBH: posts big blind 30
*** HOLE CARDS ***
Dealt to HumptyD [3s 3d]
HumptyD: raises 620 to 650 and is all-in
MARGINALBH: folds
Uncalled bet (620) returned to HumptyD
HumptyD collected 60 from pot
HumptyD: doesn't show hand
*** SUMMARY ***
Total pot 60 | Rake 0
Seat 1: HumptyD (button) (small blind) collected (60)
Seat 3: MARGINALBH (big blind) folded before Flop

PokerStars Hand #251180732184: Tournament #3770707316, $0.46+$0.04 USD Hold'em No Limit - Level III (20/40) - 2024/06/24 20:20:23 ET
Table '3770707316 1' 3-max Seat #3 is the button
Seat 1: HumptyD (680 in chips)
Seat 3: MARGINALBH (820 in chips)
MARGINALBH: posts small blind 20
HumptyD: posts big blind 40
*** HOLE CARDS ***
Dealt to HumptyD [2h 4c]
MARGINALBH: calls 20
HumptyD: checks
*** FLOP *** [Jd 7h Kh]
HumptyD: bets 40
MARGINALBH has timed out
MARGINALBH: folds
MARGINALBH is sitting out
Uncalled bet (40) returned to HumptyD
HumptyD collected 80 from pot
HumptyD: doesn't show hand
*** SUMMARY ***
Total pot 80 | Rake 0
Board [Jd 7h Kh]
Seat 1: HumptyD (big blind) collected (80)
Seat 3: MARGINALBH (button) (small blind) folded on the Flop

PokerStars Hand #251180736803: Tournament #3770707316, $0.46+$0.04 USD Hold'em No Limit - Level III (20/40) - 2024/06/24 20:20:50 ET
Table '3770707316 1' 3-max Seat #1 is the button
Seat 1: HumptyD (720 in chips)
Seat 3: MARGINALBH (780 in chips) is sitting out
HumptyD: posts small blind 20
MARGINALBH: posts big blind 40
*** HOLE CARDS ***
Dealt to HumptyD [As 3s]
HumptyD: raises 40 to 80
MARGINALBH: folds
Uncalled bet (40) returned to HumptyD
HumptyD collected 80 from pot
HumptyD: doesn't show hand
*** SUMMARY ***
Total pot 80 | Rake 0
Seat 1: HumptyD (button) (small blind) collected (80)
Seat 3: MARGINALBH (big blind) folded before Flop

PokerStars Hand #251180737263: Tournament #3770707316, $0.46+$0.04 USD Hold'em No Limit - Level III (20/40) - 2024/06/24 20:20:53 ET
Table '3770707316 1' 3-max Seat #3 is the button
Seat 1: HumptyD (760 in chips)
Seat 3: MARGINALBH (740 in chips) is sitting out
MARGINALBH: posts small blind 20
HumptyD: posts big blind 40
*** HOLE CARDS ***
Dealt to HumptyD [4s Td]
MARGINALBH: folds
Uncalled bet (20) returned to HumptyD
HumptyD collected 40 from pot
HumptyD: doesn't show hand
*** SUMMARY ***
Total pot 40 | Rake 0
Seat 1: HumptyD (big blind) collected (40)
Seat 3: MARGINALBH (button) (small blind) folded before Flop

PokerStars Hand #251180737618: Tournament #3770707316, $0.46+$0.04 USD Hold'em No Limit - Level III (20/40) - 2024/06/24 20:20:54 ET
Table '3770707316 1' 3-max Seat #1 is the button
Seat 1: HumptyD (780 in chips)
Seat 3: MARGINALBH (720 in chips) is sitting out
HumptyD: posts small blind 20
MARGINALBH: posts big blind 40
*** HOLE CARDS ***
Dealt to HumptyD [4h 9c]
HumptyD: raises 40 to 80
MARGINALBH: folds
Uncalled bet (40) returned to HumptyD
HumptyD collected 80 from pot
HumptyD: doesn't show hand
*** SUMMARY ***
Total pot 80 | Rake 0
Seat 1: HumptyD (button) (small blind) collected (80)
Seat 3: MARGINALBH (big blind) folded before Flop

PokerStars Hand #251180738118: Tournament #3770707316, $0.46+$0.04 USD Hold'em No Limit - Level III (20/40) - 2024/06/24 20:20:57 ET
Table '3770707316 1' 3-max Seat #3 is the button
Seat 1: HumptyD (820 in chips)
Seat 3: MARGINALBH (680 in chips) is sitting out
MARGINALBH: posts small blind 20
HumptyD: posts big blind 40
*** HOLE CARDS ***
Dealt to HumptyD [Ah 7h]
MARGINALBH: folds
Uncalled bet (20) returned to HumptyD
HumptyD collected 40 from pot
HumptyD: doesn't show hand
*** SUMMARY ***
Total pot 40 | Rake 0
Seat 1: HumptyD (big blind) collected (40)
Seat 3: MARGINALBH (button) (small blind) folded before Flop

PokerStars Hand #251180738429: Tournament #3770707316, $0.46+$0.04 USD Hold'em No Limit - Level III (20/40) - 2024/06/24 20:20:59 ET
Table '3770707316 1' 3-max Seat #1 is the button
Seat 1: HumptyD (840 in chips)
Seat 3: MARGINALBH (660 in chips) is sitting out
HumptyD: posts small blind 20
MARGINALBH: posts big blind 40
*** HOLE CARDS ***
Dealt to HumptyD [3s 2c]
HumptyD: raises 40 to 80
MARGINALBH: folds
Uncalled bet (40) returned to HumptyD
HumptyD collected 80 from pot
HumptyD: doesn't show hand
*** SUMMARY ***
Total pot 80 | Rake 0
Seat 1: HumptyD (button) (small blind) collected (80)
Seat 3: MARGINALBH (big blind) folded before Flop

PokerStars Hand #251180739031: Tournament #3770707316, $0.46+$0.04 USD Hold'em No Limit - Level III (20/40) - 2024/06/24 20:21:02 ET
Table '3770707316 1' 3-max Seat #3 is the button
Seat 1: HumptyD (880 in chips)
Seat 3: MARGINALBH (620 in chips) is sitting out
MARGINALBH: posts small blind 20
HumptyD: posts big blind 40
*** HOLE CARDS ***
Dealt to HumptyD [5s Ah]
MARGINALBH: folds
Uncalled bet (20) returned to HumptyD
HumptyD collected 40 from pot
HumptyD: doesn't show hand
MARGINALBH has returned
*** SUMMARY ***
Total pot 40 | Rake 0
Seat 1: HumptyD (big blind) collected (40)
Seat 3: MARGINALBH (button) (small blind) folded before Flop

PokerStars Hand #251180739350: Tournament #3770707316, $0.46+$0.04 USD Hold'em No Limit - Level III (20/40) - 2024/06/24 20:21:04 ET
Table '3770707316 1' 3-max Seat #1 is the button
Seat 1: HumptyD (900 in chips)
Seat 3: MARGINALBH (600 in chips)
HumptyD: posts small blind 20
MARGINALBH: posts big blind 40
*** HOLE CARDS ***
Dealt to HumptyD [4d 3d]
HumptyD: raises 40 to 80
MARGINALBH: raises 520 to 600 and is all-in
HumptyD: folds
Uncalled bet (520) returned to MARGINALBH
MARGINALBH collected 160 from pot
*** SUMMARY ***
Total pot 160 | Rake 0
Seat 1: HumptyD (button) (small blind) folded before Flop
Seat 3: MARGINALBH (big blind) collected (160)

PokerStars Hand #251180741767: Tournament #3770707316, $0.46+$0.04 USD Hold'em No Limit - Level III (20/40) - 2024/06/24 20:21:18 ET
Table '3770707316 1' 3-max Seat #3 is the button
Seat 1: HumptyD (820 in chips)
Seat 3: MARGINALBH (680 in chips)
MARGINALBH: posts small blind 20
HumptyD: posts big blind 40
*** HOLE CARDS ***
Dealt to HumptyD [4s Jd]
MARGINALBH: raises 640 to 680 and is all-in
HumptyD: folds
Uncalled bet (640) returned to MARGINALBH
MARGINALBH collected 80 from pot
*** SUMMARY ***
Total pot 80 | Rake 0
Seat 1: HumptyD (big blind) folded before Flop
Seat 3: MARGINALBH (button) (small blind) collected (80)

PokerStars Hand #251180743218: Tournament #3770707316, $0.46+$0.04 USD Hold'em No Limit - Level III (20/40) - 2024/06/24 20:21:26 ET
Table '3770707316 1' 3-max Seat #1 is the button
Seat 1: HumptyD (780 in chips)
Seat 3: MARGINALBH (720 in chips)
HumptyD: posts small blind 20
MARGINALBH: posts big blind 40
*** HOLE CARDS ***
Dealt to HumptyD [6h Ac]
HumptyD: calls 20
MARGINALBH: raises 680 to 720 and is all-in
HumptyD: folds
Uncalled bet (680) returned to MARGINALBH
MARGINALBH collected 80 from pot
*** SUMMARY ***
Total pot 80 | Rake 0
Seat 1: HumptyD (button) (small blind) folded before Flop
Seat 3: MARGINALBH (big blind) collected (80)

PokerStars Hand #251180744690: Tournament #3770707316, $0.46+$0.04 USD Hold'em No Limit - Level III (20/40) - 2024/06/24 20:21:34 ET
Table '3770707316 1' 3-max Seat #3 is the button
Seat 1: HumptyD (740 in chips)
Seat 3: MARGINALBH (760 in chips)
MARGINALBH: posts small blind 20
HumptyD: posts big blind 40
*** HOLE CARDS ***
Dealt to HumptyD [9h 9c]
MARGINALBH: calls 20
HumptyD: raises 700 to 740 and is all-in
MARGINALBH: folds
Uncalled bet (700) returned to HumptyD
HumptyD collected 80 from pot
HumptyD: doesn't show hand
*** SUMMARY ***
Total pot 80 | Rake 0
Seat 1: HumptyD (big blind) collected (80)
Seat 3: MARGINALBH (button) (small blind) folded before Flop

PokerStars Hand #251180746654: Tournament #3770707316, $0.46+$0.04 USD Hold'em No Limit - Level III (20/40) - 2024/06/24 20:21:45 ET
Table '3770707316 1' 3-max Seat #1 is the button
Seat 1: HumptyD (780 in chips)
Seat 3: MARGINALBH (720 in chips)
HumptyD: posts small blind 20
MARGINALBH: posts big blind 40
*** HOLE CARDS ***
Dealt to HumptyD [Kd Qs]
HumptyD: calls 20
MARGINALBH: checks
*** FLOP *** [Ts Td 4h]
MARGINALBH: checks
HumptyD: bets 40
MARGINALBH: folds
Uncalled bet (40) returned to HumptyD
HumptyD collected 80 from pot
HumptyD: doesn't show hand
*** SUMMARY ***
Total pot 80 | Rake 0
Board [Ts Td 4h]
Seat 1: HumptyD (button) (small blind) collected (80)
Seat 3: MARGINALBH (big blind) folded on the Flop

PokerStars Hand #251180749364: Tournament #3770707316, $0.46+$0.04 USD Hold'em No Limit - Level III (20/40) - 2024/06/24 20:22:01 ET
Table '3770707316 1' 3-max Seat #3 is the button
Seat 1: HumptyD (820 in chips)
Seat 3: MARGINALBH (680 in chips)
MARGINALBH: posts small blind 20
HumptyD: posts big blind 40
*** HOLE CARDS ***
Dealt to HumptyD [Qh Th]
MARGINALBH: folds
Uncalled bet (20) returned to HumptyD
HumptyD collected 40 from pot
HumptyD: doesn't show hand
*** SUMMARY ***
Total pot 40 | Rake 0
Seat 1: HumptyD (big blind) collected (40)
Seat 3: MARGINALBH (button) (small blind) folded before Flop

PokerStars Hand #251180750592: Tournament #3770707316, $0.46+$0.04 USD Hold'em No Limit - Level III (20/40) - 2024/06/24 20:22:08 ET
Table '3770707316 1' 3-max Seat #1 is the button
Seat 1: HumptyD (840 in chips)
Seat 3: MARGINALBH (660 in chips)
HumptyD: posts small blind 20
MARGINALBH: posts big blind 40
*** HOLE CARDS ***
Dealt to HumptyD [8d 5h]
HumptyD: folds
Uncalled bet (20) returned to MARGINALBH
MARGINALBH collected 40 from pot
*** SUMMARY ***
Total pot 40 | Rake 0
Seat 1: HumptyD (button) (small blind) folded before Flop
Seat 3: MARGINALBH (big blind) collected (40)

PokerStars Hand #251180751247: Tournament #3770707316, $0.46+$0.04 USD Hold'em No Limit - Level III (20/40) - 2024/06/24 20:22:11 ET
Table '3770707316 1' 3-max Seat #3 is the button
Seat 1: HumptyD (820 in chips)
Seat 3: MARGINALBH (680 in chips)
MARGINALBH: posts small blind 20
HumptyD: posts big blind 40
*** HOLE CARDS ***
Dealt to HumptyD [5c Kd]
MARGINALBH: calls 20
HumptyD: checks
*** FLOP *** [8d Jh Kc]
HumptyD: checks
MARGINALBH: checks
*** TURN *** [8d Jh Kc] [Tc]
HumptyD: bets 60
MARGINALBH: raises 100 to 160
HumptyD: calls 100
*** RIVER *** [8d Jh Kc Tc] [7d]
HumptyD: checks
MARGINALBH: bets 200
HumptyD: calls 200
*** SHOW DOWN ***
MARGINALBH: shows [Qc 9c] (a straight, Nine to King)
HumptyD: mucks hand
MARGINALBH collected 800 from pot
*** SUMMARY ***
Total pot 800 | Rake 0
Board [8d Jh Kc Tc 7d]
Seat 1: HumptyD (big blind) mucked [5c Kd]
Seat 3: MARGINALBH (button) (small blind) showed [Qc 9c] and won (800) with a straight, Nine to King

PokerStars Hand #251180757276: Tournament #3770707316, $0.46+$0.04 USD Hold'em No Limit - Level III (20/40) - 2024/06/24 20:22:45 ET
Table '3770707316 1' 3-max Seat #1 is the button
Seat 1: HumptyD (420 in chips)
Seat 3: MARGINALBH (1080 in chips)
HumptyD: posts small blind 20
MARGINALBH: posts big blind 40
*** HOLE CARDS ***
Dealt to HumptyD [Jh 4c]
HumptyD: folds
Uncalled bet (20) returned to MARGINALBH
MARGINALBH collected 40 from pot
*** SUMMARY ***
Total pot 40 | Rake 0
Seat 1: HumptyD (button) (small blind) folded before Flop
Seat 3: MARGINALBH (big blind) collected (40)

PokerStars Hand #251180758001: Tournament #3770707316, $0.46+$0.04 USD Hold'em No Limit - Level III (20/40) - 2024/06/24 20:22:49 ET
Table '3770707316 1' 3-max Seat #3 is the button
Seat 1: HumptyD (400 in chips)
Seat 3: MARGINALBH (1100 in chips)
MARGINALBH: posts small blind 20
HumptyD: posts big blind 40
*** HOLE CARDS ***
Dealt to HumptyD [9s Ah]
MARGINALBH: raises 40 to 80
HumptyD: raises 320 to 400 and is all-in
MARGINALBH: calls 320
*** FLOP *** [8h Ad 6h]
*** TURN *** [8h Ad 6h] [7h]
*** RIVER *** [8h Ad 6h 7h] [6c]
*** SHOW DOWN ***
HumptyD: shows [9s Ah] (two pair, Aces and Sixes)
MARGINALBH: shows [Th As] (two pair, Aces and Sixes - Ten kicker)
MARGINALBH collected 800 from pot
HumptyD finished the tournament in 2nd place
MARGINALBH wins the tournament - congratulations!
MARGINALBH wins a '$11 Power Path Step 3' ticket
*** SUMMARY ***
Total pot 800 | Rake 0
Board [8h Ad 6h 7h 6c]
Seat 1: HumptyD (big blind) showed [9s Ah] and lost with two pair, Aces and Sixes
Seat 3: MARGINALBH (button) (small blind) showed [Th As] and won (800) with two pair, Aces and Sixes


Hand ID: 5

PokerStars Hand #251180669072: Tournament #3770707384, $0.46+$0.04 USD Hold'em No Limit - Level I (10/20) - 2024/06/24 20:14:24 ET
Table '3770707384 1' 3-max Seat #1 is the button
Seat 1: wiiiiiiiiinnooo (500 in chips)
Seat 2: HumptyD (500 in chips)
Seat 3: Aktarus45 (500 in chips)
HumptyD: posts small blind 10
Aktarus45: posts big blind 20
*** HOLE CARDS ***
Dealt to HumptyD [8s 6c]
wiiiiiiiiinnooo: raises 480 to 500 and is all-in
HumptyD: folds
Aktarus45: folds
Uncalled bet (480) returned to wiiiiiiiiinnooo
wiiiiiiiiinnooo collected 50 from pot
wiiiiiiiiinnooo: doesn't show hand
*** SUMMARY ***
Total pot 50 | Rake 0
Seat 1: wiiiiiiiiinnooo (button) collected (50)
Seat 2: HumptyD (small blind) folded before Flop
Seat 3: Aktarus45 (big blind) folded before Flop

PokerStars Hand #251180671588: Tournament #3770707384, $0.46+$0.04 USD Hold'em No Limit - Level I (10/20) - 2024/06/24 20:14:38 ET
Table '3770707384 1' 3-max Seat #2 is the button
Seat 1: wiiiiiiiiinnooo (530 in chips)
Seat 2: HumptyD (490 in chips)
Seat 3: Aktarus45 (480 in chips)
Aktarus45: posts small blind 10
wiiiiiiiiinnooo: posts big blind 20
*** HOLE CARDS ***
Dealt to HumptyD [Ad 4s]
HumptyD: folds
Aktarus45: calls 10
wiiiiiiiiinnooo: raises 510 to 530 and is all-in
Aktarus45: folds
Uncalled bet (510) returned to wiiiiiiiiinnooo
wiiiiiiiiinnooo collected 40 from pot
wiiiiiiiiinnooo: doesn't show hand
*** SUMMARY ***
Total pot 40 | Rake 0
Seat 1: wiiiiiiiiinnooo (big blind) collected (40)
Seat 2: HumptyD (button) folded before Flop (didn't bet)
Seat 3: Aktarus45 (small blind) folded before Flop

PokerStars Hand #251180677401: Tournament #3770707384, $0.46+$0.04 USD Hold'em No Limit - Level I (10/20) - 2024/06/24 20:15:10 ET
Table '3770707384 1' 3-max Seat #3 is the button
Seat 1: wiiiiiiiiinnooo (550 in chips)
Seat 2: HumptyD (490 in chips)
Seat 3: Aktarus45 (460 in chips)
wiiiiiiiiinnooo: posts small blind 10
HumptyD: posts big blind 20
*** HOLE CARDS ***
Dealt to HumptyD [4h 4d]
Aktarus45: folds
wiiiiiiiiinnooo: calls 10
HumptyD: raises 470 to 490 and is all-in
wiiiiiiiiinnooo: folds
Uncalled bet (470) returned to HumptyD
HumptyD collected 40 from pot
HumptyD: doesn't show hand
*** SUMMARY ***
Total pot 40 | Rake 0
Seat 1: wiiiiiiiiinnooo (small blind) folded before Flop
Seat 2: HumptyD (big blind) collected (40)
Seat 3: Aktarus45 (button) folded before Flop (didn't bet)

PokerStars Hand #251180681478: Tournament #3770707384, $0.46+$0.04 USD Hold'em No Limit - Level I (10/20) - 2024/06/24 20:15:33 ET
Table '3770707384 1' 3-max Seat #1 is the button
Seat 1: wiiiiiiiiinnooo (530 in chips)
Seat 2: HumptyD (510 in chips)
Seat 3: Aktarus45 (460 in chips)
HumptyD: posts small blind 10
Aktarus45: posts big blind 20
*** HOLE CARDS ***
Dealt to HumptyD [Td 4s]
wiiiiiiiiinnooo: raises 510 to 530 and is all-in
HumptyD: folds
Aktarus45: folds
Uncalled bet (510) returned to wiiiiiiiiinnooo
wiiiiiiiiinnooo collected 50 from pot
wiiiiiiiiinnooo: doesn't show hand
*** SUMMARY ***
Total pot 50 | Rake 0
Seat 1: wiiiiiiiiinnooo (button) collected (50)
Seat 2: HumptyD (small blind) folded before Flop
Seat 3: Aktarus45 (big blind) folded before Flop

PokerStars Hand #251180684511: Tournament #3770707384, $0.46+$0.04 USD Hold'em No Limit - Level I (10/20) - 2024/06/24 20:15:50 ET
Table '3770707384 1' 3-max Seat #2 is the button
Seat 1: wiiiiiiiiinnooo (560 in chips)
Seat 2: HumptyD (500 in chips)
Seat 3: Aktarus45 (440 in chips)
Aktarus45: posts small blind 10
wiiiiiiiiinnooo: posts big blind 20
*** HOLE CARDS ***
Dealt to HumptyD [6h As]
HumptyD: folds
Aktarus45: calls 10
wiiiiiiiiinnooo: raises 540 to 560 and is all-in
Aktarus45: folds
Uncalled bet (540) returned to wiiiiiiiiinnooo
wiiiiiiiiinnooo collected 40 from pot
wiiiiiiiiinnooo: doesn't show hand
*** SUMMARY ***
Total pot 40 | Rake 0
Seat 1: wiiiiiiiiinnooo (big blind) collected (40)
Seat 2: HumptyD (button) folded before Flop (didn't bet)
Seat 3: Aktarus45 (small blind) folded before Flop

PokerStars Hand #251180689782: Tournament #3770707384, $0.46+$0.04 USD Hold'em No Limit - Level I (10/20) - 2024/06/24 20:16:20 ET
Table '3770707384 1' 3-max Seat #3 is the button
Seat 1: wiiiiiiiiinnooo (580 in chips)
Seat 2: HumptyD (500 in chips)
Seat 3: Aktarus45 (420 in chips)
wiiiiiiiiinnooo: posts small blind 10
HumptyD: posts big blind 20
*** HOLE CARDS ***
Dealt to HumptyD [7d 5h]
Aktarus45: folds
wiiiiiiiiinnooo: folds
Uncalled bet (10) returned to HumptyD
HumptyD collected 20 from pot
HumptyD: doesn't show hand
*** SUMMARY ***
Total pot 20 | Rake 0
Seat 1: wiiiiiiiiinnooo (small blind) folded before Flop
Seat 2: HumptyD (big blind) collected (20)
Seat 3: Aktarus45 (button) folded before Flop (didn't bet)

PokerStars Hand #251180692200: Tournament #3770707384, $0.46+$0.04 USD Hold'em No Limit - Level II (15/30) - 2024/06/24 20:16:34 ET
Table '3770707384 1' 3-max Seat #1 is the button
Seat 1: wiiiiiiiiinnooo (570 in chips)
Seat 2: HumptyD (510 in chips)
Seat 3: Aktarus45 (420 in chips)
HumptyD: posts small blind 15
Aktarus45: posts big blind 30
*** HOLE CARDS ***
Dealt to HumptyD [Tc Kc]
wiiiiiiiiinnooo: folds
HumptyD: calls 15
Aktarus45: checks
*** FLOP *** [Qc Ah 7c]
HumptyD: bets 30
Aktarus45: calls 30
*** TURN *** [Qc Ah 7c] [As]
HumptyD: bets 90
Aktarus45: calls 90
*** RIVER *** [Qc Ah 7c As] [3d]
HumptyD: checks
Aktarus45: checks
*** SHOW DOWN ***
HumptyD: shows [Tc Kc] (a pair of Aces)
Aktarus45: shows [2s 7s] (two pair, Aces and Sevens)
Aktarus45 collected 300 from pot
*** SUMMARY ***
Total pot 300 | Rake 0
Board [Qc Ah 7c As 3d]
Seat 1: wiiiiiiiiinnooo (button) folded before Flop (didn't bet)
Seat 2: HumptyD (small blind) showed [Tc Kc] and lost with a pair of Aces
Seat 3: Aktarus45 (big blind) showed [2s 7s] and won (300) with two pair, Aces and Sevens

PokerStars Hand #251180698936: Tournament #3770707384, $0.46+$0.04 USD Hold'em No Limit - Level II (15/30) - 2024/06/24 20:17:12 ET
Table '3770707384 1' 3-max Seat #2 is the button
Seat 1: wiiiiiiiiinnooo (570 in chips)
Seat 2: HumptyD (360 in chips)
Seat 3: Aktarus45 (570 in chips)
Aktarus45: posts small blind 15
wiiiiiiiiinnooo: posts big blind 30
*** HOLE CARDS ***
Dealt to HumptyD [8s Jc]
HumptyD: folds
Aktarus45: calls 15
wiiiiiiiiinnooo: checks
*** FLOP *** [Ah Qh 4s]
Aktarus45: checks
wiiiiiiiiinnooo: checks
*** TURN *** [Ah Qh 4s] [Js]
Aktarus45: checks
wiiiiiiiiinnooo: checks
*** RIVER *** [Ah Qh 4s Js] [4h]
Aktarus45: bets 60
wiiiiiiiiinnooo: folds
Uncalled bet (60) returned to Aktarus45
Aktarus45 collected 60 from pot
Aktarus45: doesn't show hand
*** SUMMARY ***
Total pot 60 | Rake 0
Board [Ah Qh 4s Js 4h]
Seat 1: wiiiiiiiiinnooo (big blind) folded on the River
Seat 2: HumptyD (button) folded before Flop (didn't bet)
Seat 3: Aktarus45 (small blind) collected (60)

PokerStars Hand #251180705425: Tournament #3770707384, $0.46+$0.04 USD Hold'em No Limit - Level II (15/30) - 2024/06/24 20:17:50 ET
Table '3770707384 1' 3-max Seat #3 is the button
Seat 1: wiiiiiiiiinnooo (540 in chips)
Seat 2: HumptyD (360 in chips)
Seat 3: Aktarus45 (600 in chips)
wiiiiiiiiinnooo: posts small blind 15
HumptyD: posts big blind 30
*** HOLE CARDS ***
Dealt to HumptyD [Qs 3s]
Aktarus45: folds
wiiiiiiiiinnooo: raises 510 to 540 and is all-in
HumptyD: folds
Uncalled bet (510) returned to wiiiiiiiiinnooo
wiiiiiiiiinnooo collected 60 from pot
wiiiiiiiiinnooo: doesn't show hand
*** SUMMARY ***
Total pot 60 | Rake 0
Seat 1: wiiiiiiiiinnooo (small blind) collected (60)
Seat 2: HumptyD (big blind) folded before Flop
Seat 3: Aktarus45 (button) folded before Flop (didn't bet)

PokerStars Hand #251180709349: Tournament #3770707384, $0.46+$0.04 USD Hold'em No Limit - Level II (15/30) - 2024/06/24 20:18:12 ET
Table '3770707384 1' 3-max Seat #1 is the button
Seat 1: wiiiiiiiiinnooo (570 in chips)
Seat 2: HumptyD (330 in chips)
Seat 3: Aktarus45 (600 in chips)
HumptyD: posts small blind 15
Aktarus45: posts big blind 30
*** HOLE CARDS ***
Dealt to HumptyD [9s 3c]
wiiiiiiiiinnooo: raises 540 to 570 and is all-in
HumptyD: folds
Aktarus45: folds
Uncalled bet (540) returned to wiiiiiiiiinnooo
wiiiiiiiiinnooo collected 75 from pot
wiiiiiiiiinnooo: doesn't show hand
*** SUMMARY ***
Total pot 75 | Rake 0
Seat 1: wiiiiiiiiinnooo (button) collected (75)
Seat 2: HumptyD (small blind) folded before Flop
Seat 3: Aktarus45 (big blind) folded before Flop

PokerStars Hand #251180712462: Tournament #3770707384, $0.46+$0.04 USD Hold'em No Limit - Level III (20/40) - 2024/06/24 20:18:30 ET
Table '3770707384 1' 3-max Seat #2 is the button
Seat 1: wiiiiiiiiinnooo (615 in chips)
Seat 2: HumptyD (315 in chips)
Seat 3: Aktarus45 (570 in chips)
Aktarus45: posts small blind 20
wiiiiiiiiinnooo: posts big blind 40
*** HOLE CARDS ***
Dealt to HumptyD [Jh 3c]
HumptyD: folds
Aktarus45: calls 20
wiiiiiiiiinnooo: checks
*** FLOP *** [3h 9d 4s]
Aktarus45: checks
wiiiiiiiiinnooo: checks
*** TURN *** [3h 9d 4s] [Js]
Aktarus45: checks
wiiiiiiiiinnooo: checks
*** RIVER *** [3h 9d 4s Js] [Jd]
Aktarus45: checks
wiiiiiiiiinnooo: checks
*** SHOW DOWN ***
Aktarus45: shows [2d 6h] (a pair of Jacks)
wiiiiiiiiinnooo: shows [7c 3d] (two pair, Jacks and Threes)
wiiiiiiiiinnooo collected 80 from pot
*** SUMMARY ***
Total pot 80 | Rake 0
Board [3h 9d 4s Js Jd]
Seat 1: wiiiiiiiiinnooo (big blind) showed [7c 3d] and won (80) with two pair, Jacks and Threes
Seat 2: HumptyD (button) folded before Flop (didn't bet)
Seat 3: Aktarus45 (small blind) showed [2d 6h] and lost with a pair of Jacks

PokerStars Hand #251180716758: Tournament #3770707384, $0.46+$0.04 USD Hold'em No Limit - Level III (20/40) - 2024/06/24 20:18:54 ET
Table '3770707384 1' 3-max Seat #3 is the button
Seat 1: wiiiiiiiiinnooo (655 in chips)
Seat 2: HumptyD (315 in chips)
Seat 3: Aktarus45 (530 in chips)
wiiiiiiiiinnooo: posts small blind 20
HumptyD: posts big blind 40
*** HOLE CARDS ***
Dealt to HumptyD [9c Ts]
Aktarus45: folds
wiiiiiiiiinnooo: calls 20
HumptyD: raises 275 to 315 and is all-in
wiiiiiiiiinnooo: calls 275
*** FLOP *** [4s 8c Jc]
*** TURN *** [4s 8c Jc] [8d]
*** RIVER *** [4s 8c Jc 8d] [6h]
*** SHOW DOWN ***
wiiiiiiiiinnooo: shows [Qd Qc] (two pair, Queens and Eights)
HumptyD: shows [9c Ts] (a pair of Eights)
wiiiiiiiiinnooo collected 630 from pot
HumptyD finished the tournament in 3rd place
*** SUMMARY ***
Total pot 630 | Rake 0
Board [4s 8c Jc 8d 6h]
Seat 1: wiiiiiiiiinnooo (small blind) showed [Qd Qc] and won (630) with two pair, Queens and Eights
Seat 2: HumptyD (big blind) showed [9c Ts] and lost with a pair of Eights
Seat 3: Aktarus45 (button) folded before Flop (didn't bet)


Hand ID: 6

PokerStars Hand #251180670665: Tournament #3770707419, $0.46+$0.04 USD Hold'em No Limit - Level I (10/20) - 2024/06/24 20:14:32 ET
Table '3770707419 1' 3-max Seat #1 is the button
Seat 1: HumptyD (500 in chips)
Seat 2: cllaytoon (500 in chips)
Seat 3: dfriedrich (500 in chips)
cllaytoon: posts small blind 10
dfriedrich: posts big blind 20
*** HOLE CARDS ***
Dealt to HumptyD [4s 8h]
HumptyD: folds
cllaytoon: raises 480 to 500 and is all-in
dfriedrich: folds
Uncalled bet (480) returned to cllaytoon
cllaytoon collected 40 from pot
*** SUMMARY ***
Total pot 40 | Rake 0
Seat 1: HumptyD (button) folded before Flop (didn't bet)
Seat 2: cllaytoon (small blind) collected (40)
Seat 3: dfriedrich (big blind) folded before Flop

PokerStars Hand #251180672913: Tournament #3770707419, $0.46+$0.04 USD Hold'em No Limit - Level I (10/20) - 2024/06/24 20:14:45 ET
Table '3770707419 1' 3-max Seat #2 is the button
Seat 1: HumptyD (500 in chips)
Seat 2: cllaytoon (520 in chips)
Seat 3: dfriedrich (480 in chips)
dfriedrich: posts small blind 10
HumptyD: posts big blind 20
*** HOLE CARDS ***
Dealt to HumptyD [Ts 2c]
cllaytoon: raises 500 to 520 and is all-in
dfriedrich: folds
HumptyD: folds
Uncalled bet (500) returned to cllaytoon
cllaytoon collected 50 from pot
*** SUMMARY ***
Total pot 50 | Rake 0
Seat 1: HumptyD (big blind) folded before Flop
Seat 2: cllaytoon (button) collected (50)
Seat 3: dfriedrich (small blind) folded before Flop

PokerStars Hand #251180675015: Tournament #3770707419, $0.46+$0.04 USD Hold'em No Limit - Level I (10/20) - 2024/06/24 20:14:57 ET
Table '3770707419 1' 3-max Seat #3 is the button
Seat 1: HumptyD (480 in chips)
Seat 2: cllaytoon (550 in chips)
Seat 3: dfriedrich (470 in chips)
HumptyD: posts small blind 10
cllaytoon: posts big blind 20
*** HOLE CARDS ***
Dealt to HumptyD [6d 5d]
dfriedrich: folds
HumptyD: calls 10
cllaytoon: raises 530 to 550 and is all-in
HumptyD: folds
Uncalled bet (530) returned to cllaytoon
cllaytoon collected 40 from pot
*** SUMMARY ***
Total pot 40 | Rake 0
Seat 1: HumptyD (small blind) folded before Flop
Seat 2: cllaytoon (big blind) collected (40)
Seat 3: dfriedrich (button) folded before Flop (didn't bet)

PokerStars Hand #251180678738: Tournament #3770707419, $0.46+$0.04 USD Hold'em No Limit - Level I (10/20) - 2024/06/24 20:15:17 ET
Table '3770707419 1' 3-max Seat #1 is the button
Seat 1: HumptyD (460 in chips)
Seat 2: cllaytoon (570 in chips)
Seat 3: dfriedrich (470 in chips)
cllaytoon: posts small blind 10
dfriedrich: posts big blind 20
*** HOLE CARDS ***
Dealt to HumptyD [Qs 7h]
HumptyD: folds
cllaytoon: folds
Uncalled bet (10) returned to dfriedrich
dfriedrich collected 20 from pot
*** SUMMARY ***
Total pot 20 | Rake 0
Seat 1: HumptyD (button) folded before Flop (didn't bet)
Seat 2: cllaytoon (small blind) folded before Flop
Seat 3: dfriedrich (big blind) collected (20)

PokerStars Hand #251180682401: Tournament #3770707419, $0.46+$0.04 USD Hold'em No Limit - Level I (10/20) - 2024/06/24 20:15:38 ET
Table '3770707419 1' 3-max Seat #2 is the button
Seat 1: HumptyD (460 in chips)
Seat 2: cllaytoon (560 in chips)
Seat 3: dfriedrich (480 in chips)
dfriedrich: posts small blind 10
HumptyD: posts big blind 20
*** HOLE CARDS ***
Dealt to HumptyD [4c 7d]
cllaytoon: folds
dfriedrich: folds
Uncalled bet (10) returned to HumptyD
HumptyD collected 20 from pot
HumptyD: doesn't show hand
*** SUMMARY ***
Total pot 20 | Rake 0
Seat 1: HumptyD (big blind) collected (20)
Seat 2: cllaytoon (button) folded before Flop (didn't bet)
Seat 3: dfriedrich (small blind) folded before Flop

PokerStars Hand #251180683304: Tournament #3770707419, $0.46+$0.04 USD Hold'em No Limit - Level I (10/20) - 2024/06/24 20:15:43 ET
Table '3770707419 1' 3-max Seat #3 is the button
Seat 1: HumptyD (470 in chips)
Seat 2: cllaytoon (560 in chips)
Seat 3: dfriedrich (470 in chips)
HumptyD: posts small blind 10
cllaytoon: posts big blind 20
*** HOLE CARDS ***
Dealt to HumptyD [8h 2s]
dfriedrich: raises 20 to 40
HumptyD: folds
cllaytoon: folds
Uncalled bet (20) returned to dfriedrich
dfriedrich collected 50 from pot
*** SUMMARY ***
Total pot 50 | Rake 0
Seat 1: HumptyD (small blind) folded before Flop
Seat 2: cllaytoon (big blind) folded before Flop
Seat 3: dfriedrich (button) collected (50)

PokerStars Hand #251180686017: Tournament #3770707419, $0.46+$0.04 USD Hold'em No Limit - Level I (10/20) - 2024/06/24 20:15:59 ET
Table '3770707419 1' 3-max Seat #1 is the button
Seat 1: HumptyD (460 in chips)
Seat 2: cllaytoon (540 in chips)
Seat 3: dfriedrich (500 in chips)
cllaytoon: posts small blind 10
dfriedrich: posts big blind 20
*** HOLE CARDS ***
Dealt to HumptyD [Ks 9c]
HumptyD: raises 20 to 40
cllaytoon: folds
dfriedrich: calls 20
*** FLOP *** [3d 8h Qs]
dfriedrich: checks
HumptyD: checks
*** TURN *** [3d 8h Qs] [9h]
dfriedrich: bets 30
HumptyD: calls 30
*** RIVER *** [3d 8h Qs 9h] [7c]
dfriedrich: checks
HumptyD: checks
*** SHOW DOWN ***
dfriedrich: shows [3h Kc] (a pair of Threes)
HumptyD: shows [Ks 9c] (a pair of Nines)
HumptyD collected 150 from pot
*** SUMMARY ***
Total pot 150 | Rake 0
Board [3d 8h Qs 9h 7c]
Seat 1: HumptyD (button) showed [Ks 9c] and won (150) with a pair of Nines
Seat 2: cllaytoon (small blind) folded before Flop
Seat 3: dfriedrich (big blind) showed [3h Kc] and lost with a pair of Threes

PokerStars Hand #251180691810: Tournament #3770707419, $0.46+$0.04 USD Hold'em No Limit - Level I (10/20) - 2024/06/24 20:16:32 ET
Table '3770707419 1' 3-max Seat #2 is the button
Seat 1: HumptyD (540 in chips)
Seat 2: cllaytoon (530 in chips)
Seat 3: dfriedrich (430 in chips)
dfriedrich: posts small blind 10
HumptyD: posts big blind 20
*** HOLE CARDS ***
Dealt to HumptyD [Qs 7c]
cllaytoon: folds
dfriedrich: raises 410 to 430 and is all-in
HumptyD: folds
Uncalled bet (410) returned to dfriedrich
dfriedrich collected 40 from pot
*** SUMMARY ***
Total pot 40 | Rake 0
Seat 1: HumptyD (big blind) folded before Flop
Seat 2: cllaytoon (button) folded before Flop (didn't bet)
Seat 3: dfriedrich (small blind) collected (40)

PokerStars Hand #251180694764: Tournament #3770707419, $0.46+$0.04 USD Hold'em No Limit - Level II (15/30) - 2024/06/24 20:16:48 ET
Table '3770707419 1' 3-max Seat #3 is the button
Seat 1: HumptyD (520 in chips)
Seat 2: cllaytoon (530 in chips)
Seat 3: dfriedrich (450 in chips)
HumptyD: posts small blind 15
cllaytoon: posts big blind 30
*** HOLE CARDS ***
Dealt to HumptyD [9c Th]
dfriedrich: raises 420 to 450 and is all-in
HumptyD: folds
cllaytoon: calls 420
*** FLOP *** [Ts 5d 3c]
*** TURN *** [Ts 5d 3c] [6d]
*** RIVER *** [Ts 5d 3c 6d] [7h]
*** SHOW DOWN ***
cllaytoon: shows [6s 6h] (three of a kind, Sixes)
dfriedrich: shows [Qd Jd] (high card Queen)
cllaytoon collected 915 from pot
dfriedrich finished the tournament in 3rd place
*** SUMMARY ***
Total pot 915 | Rake 0
Board [Ts 5d 3c 6d 7h]
Seat 1: HumptyD (small blind) folded before Flop
Seat 2: cllaytoon (big blind) showed [6s 6h] and won (915) with three of a kind, Sixes
Seat 3: dfriedrich (button) showed [Qd Jd] and lost with high card Queen

PokerStars Hand #251180698363: Tournament #3770707419, $0.46+$0.04 USD Hold'em No Limit - Level II (15/30) - 2024/06/24 20:17:09 ET
Table '3770707419 1' 3-max Seat #2 is the button
Seat 1: HumptyD (505 in chips)
Seat 2: cllaytoon (995 in chips)
cllaytoon: posts small blind 15
HumptyD: posts big blind 30
*** HOLE CARDS ***
Dealt to HumptyD [9h As]
cllaytoon: calls 15
HumptyD: raises 475 to 505 and is all-in
cllaytoon: folds
Uncalled bet (475) returned to HumptyD
HumptyD collected 60 from pot
HumptyD: doesn't show hand
*** SUMMARY ***
Total pot 60 | Rake 0
Seat 1: HumptyD (big blind) collected (60)
Seat 2: cllaytoon (button) (small blind) folded before Flop

PokerStars Hand #251180700062: Tournament #3770707419, $0.46+$0.04 USD Hold'em No Limit - Level II (15/30) - 2024/06/24 20:17:19 ET
Table '3770707419 1' 3-max Seat #1 is the button
Seat 1: HumptyD (535 in chips)
Seat 2: cllaytoon (965 in chips)
HumptyD: posts small blind 15
cllaytoon: posts big blind 30
*** HOLE CARDS ***
Dealt to HumptyD [Ah 4h]
HumptyD: calls 15
cllaytoon: checks
*** FLOP *** [4s 3h Ac]
cllaytoon: checks
HumptyD: bets 30
cllaytoon: calls 30
*** TURN *** [4s 3h Ac] [2c]
cllaytoon: checks
HumptyD: checks
*** RIVER *** [4s 3h Ac 2c] [6h]
cllaytoon: bets 36
HumptyD: calls 36
*** SHOW DOWN ***
cllaytoon: shows [2h Qd] (a pair of Deuces)
HumptyD: shows [Ah 4h] (two pair, Aces and Fours)
HumptyD collected 192 from pot
*** SUMMARY ***
Total pot 192 | Rake 0
Board [4s 3h Ac 2c 6h]
Seat 1: HumptyD (button) (small blind) showed [Ah 4h] and won (192) with two pair, Aces and Fours
Seat 2: cllaytoon (big blind) showed [2h Qd] and lost with a pair of Deuces

PokerStars Hand #251180704307: Tournament #3770707419, $0.46+$0.04 USD Hold'em No Limit - Level II (15/30) - 2024/06/24 20:17:43 ET
Table '3770707419 1' 3-max Seat #2 is the button
Seat 1: HumptyD (631 in chips)
Seat 2: cllaytoon (869 in chips)
cllaytoon: posts small blind 15
HumptyD: posts big blind 30
*** HOLE CARDS ***
Dealt to HumptyD [4s Qh]
cllaytoon: raises 60 to 90
HumptyD: folds
Uncalled bet (60) returned to cllaytoon
cllaytoon collected 60 from pot
*** SUMMARY ***
Total pot 60 | Rake 0
Seat 1: HumptyD (big blind) folded before Flop
Seat 2: cllaytoon (button) (small blind) collected (60)

PokerStars Hand #251180705581: Tournament #3770707419, $0.46+$0.04 USD Hold'em No Limit - Level II (15/30) - 2024/06/24 20:17:50 ET
Table '3770707419 1' 3-max Seat #1 is the button
Seat 1: HumptyD (601 in chips)
Seat 2: cllaytoon (899 in chips)
HumptyD: posts small blind 15
cllaytoon: posts big blind 30
*** HOLE CARDS ***
Dealt to HumptyD [Jd 6s]
HumptyD: folds
Uncalled bet (15) returned to cllaytoon
cllaytoon collected 30 from pot
*** SUMMARY ***
Total pot 30 | Rake 0
Seat 1: HumptyD (button) (small blind) folded before Flop
Seat 2: cllaytoon (big blind) collected (30)

PokerStars Hand #251180706299: Tournament #3770707419, $0.46+$0.04 USD Hold'em No Limit - Level II (15/30) - 2024/06/24 20:17:55 ET
Table '3770707419 1' 3-max Seat #2 is the button
Seat 1: HumptyD (586 in chips)
Seat 2: cllaytoon (914 in chips)
cllaytoon: posts small blind 15
HumptyD: posts big blind 30
*** HOLE CARDS ***
Dealt to HumptyD [9h 8d]
cllaytoon: raises 30 to 60
HumptyD: calls 30
*** FLOP *** [As 7s 3h]
HumptyD: checks
cllaytoon: bets 60
HumptyD: folds
Uncalled bet (60) returned to cllaytoon
cllaytoon collected 120 from pot
*** SUMMARY ***
Total pot 120 | Rake 0
Board [As 7s 3h]
Seat 1: HumptyD (big blind) folded on the Flop
Seat 2: cllaytoon (button) (small blind) collected (120)

PokerStars Hand #251180710417: Tournament #3770707419, $0.46+$0.04 USD Hold'em No Limit - Level II (15/30) - 2024/06/24 20:18:18 ET
Table '3770707419 1' 3-max Seat #1 is the button
Seat 1: HumptyD (526 in chips)
Seat 2: cllaytoon (974 in chips)
HumptyD: posts small blind 15
cllaytoon: posts big blind 30
*** HOLE CARDS ***
Dealt to HumptyD [Qd Ts]
HumptyD: calls 15
cllaytoon: checks
*** FLOP *** [9h 6c 7h]
cllaytoon: checks
HumptyD: checks
*** TURN *** [9h 6c 7h] [Kc]
cllaytoon: checks
HumptyD: checks
*** RIVER *** [9h 6c 7h Kc] [3h]
cllaytoon: checks
HumptyD: checks
*** SHOW DOWN ***
cllaytoon: shows [3c Td] (a pair of Threes)
HumptyD: mucks hand
cllaytoon collected 60 from pot
*** SUMMARY ***
Total pot 60 | Rake 0
Board [9h 6c 7h Kc 3h]
Seat 1: HumptyD (button) (small blind) mucked [Qd Ts]
Seat 2: cllaytoon (big blind) showed [3c Td] and won (60) with a pair of Threes

PokerStars Hand #251180717731: Tournament #3770707419, $0.46+$0.04 USD Hold'em No Limit - Level III (20/40) - 2024/06/24 20:19:00 ET
Table '3770707419 1' 3-max Seat #2 is the button
Seat 1: HumptyD (496 in chips)
Seat 2: cllaytoon (1004 in chips)
cllaytoon: posts small blind 20
HumptyD: posts big blind 40
*** HOLE CARDS ***
Dealt to HumptyD [8s 4d]
cllaytoon: calls 20
HumptyD: checks
*** FLOP *** [Kc 8c Jd]
HumptyD: checks
cllaytoon: bets 40
HumptyD: folds
Uncalled bet (40) returned to cllaytoon
cllaytoon collected 80 from pot
*** SUMMARY ***
Total pot 80 | Rake 0
Board [Kc 8c Jd]
Seat 1: HumptyD (big blind) folded on the Flop
Seat 2: cllaytoon (button) (small blind) collected (80)

PokerStars Hand #251180720625: Tournament #3770707419, $0.46+$0.04 USD Hold'em No Limit - Level III (20/40) - 2024/06/24 20:19:16 ET
Table '3770707419 1' 3-max Seat #1 is the button
Seat 1: HumptyD (456 in chips)
Seat 2: cllaytoon (1044 in chips)
HumptyD: posts small blind 20
cllaytoon: posts big blind 40
*** HOLE CARDS ***
Dealt to HumptyD [3s 7d]
HumptyD: folds
Uncalled bet (20) returned to cllaytoon
cllaytoon collected 40 from pot
*** SUMMARY ***
Total pot 40 | Rake 0
Seat 1: HumptyD (button) (small blind) folded before Flop
Seat 2: cllaytoon (big blind) collected (40)

PokerStars Hand #251180721929: Tournament #3770707419, $0.46+$0.04 USD Hold'em No Limit - Level III (20/40) - 2024/06/24 20:19:24 ET
Table '3770707419 1' 3-max Seat #2 is the button
Seat 1: HumptyD (436 in chips)
Seat 2: cllaytoon (1064 in chips)
cllaytoon: posts small blind 20
HumptyD: posts big blind 40
*** HOLE CARDS ***
Dealt to HumptyD [Qs Tc]
cllaytoon: calls 20
HumptyD: raises 396 to 436 and is all-in
cllaytoon: folds
Uncalled bet (396) returned to HumptyD
HumptyD collected 80 from pot
HumptyD: doesn't show hand
*** SUMMARY ***
Total pot 80 | Rake 0
Seat 1: HumptyD (big blind) collected (80)
Seat 2: cllaytoon (button) (small blind) folded before Flop

PokerStars Hand #251180724096: Tournament #3770707419, $0.46+$0.04 USD Hold'em No Limit - Level III (20/40) - 2024/06/24 20:19:37 ET
Table '3770707419 1' 3-max Seat #1 is the button
Seat 1: HumptyD (476 in chips)
Seat 2: cllaytoon (1024 in chips)
HumptyD: posts small blind 20
cllaytoon: posts big blind 40
*** HOLE CARDS ***
Dealt to HumptyD [4h 9c]
HumptyD: folds
Uncalled bet (20) returned to cllaytoon
cllaytoon collected 40 from pot
*** SUMMARY ***
Total pot 40 | Rake 0
Seat 1: HumptyD (button) (small blind) folded before Flop
Seat 2: cllaytoon (big blind) collected (40)

PokerStars Hand #251180724925: Tournament #3770707419, $0.46+$0.04 USD Hold'em No Limit - Level III (20/40) - 2024/06/24 20:19:41 ET
Table '3770707419 1' 3-max Seat #2 is the button
Seat 1: HumptyD (456 in chips)
Seat 2: cllaytoon (1044 in chips)
cllaytoon: posts small blind 20
HumptyD: posts big blind 40
*** HOLE CARDS ***
Dealt to HumptyD [2d Th]
cllaytoon: raises 1004 to 1044 and is all-in
HumptyD: folds
Uncalled bet (1004) returned to cllaytoon
cllaytoon collected 80 from pot
*** SUMMARY ***
Total pot 80 | Rake 0
Seat 1: HumptyD (big blind) folded before Flop
Seat 2: cllaytoon (button) (small blind) collected (80)

PokerStars Hand #251180726083: Tournament #3770707419, $0.46+$0.04 USD Hold'em No Limit - Level III (20/40) - 2024/06/24 20:19:48 ET
Table '3770707419 1' 3-max Seat #1 is the button
Seat 1: HumptyD (416 in chips)
Seat 2: cllaytoon (1084 in chips)
HumptyD: posts small blind 20
cllaytoon: posts big blind 40
*** HOLE CARDS ***
Dealt to HumptyD [4c Qd]
HumptyD: folds
Uncalled bet (20) returned to cllaytoon
cllaytoon collected 40 from pot
*** SUMMARY ***
Total pot 40 | Rake 0
Seat 1: HumptyD (button) (small blind) folded before Flop
Seat 2: cllaytoon (big blind) collected (40)

PokerStars Hand #251180727137: Tournament #3770707419, $0.46+$0.04 USD Hold'em No Limit - Level III (20/40) - 2024/06/24 20:19:54 ET
Table '3770707419 1' 3-max Seat #2 is the button
Seat 1: HumptyD (396 in chips)
Seat 2: cllaytoon (1104 in chips)
cllaytoon: posts small blind 20
HumptyD: posts big blind 40
*** HOLE CARDS ***
Dealt to HumptyD [Th Jd]
cllaytoon: folds
Uncalled bet (20) returned to HumptyD
HumptyD collected 40 from pot
HumptyD: doesn't show hand
*** SUMMARY ***
Total pot 40 | Rake 0
Seat 1: HumptyD (big blind) collected (40)
Seat 2: cllaytoon (button) (small blind) folded before Flop

PokerStars Hand #251180728157: Tournament #3770707419, $0.46+$0.04 USD Hold'em No Limit - Level III (20/40) - 2024/06/24 20:20:00 ET
Table '3770707419 1' 3-max Seat #1 is the button
Seat 1: HumptyD (416 in chips)
Seat 2: cllaytoon (1084 in chips)
HumptyD: posts small blind 20
cllaytoon: posts big blind 40
*** HOLE CARDS ***
Dealt to HumptyD [3s 4h]
HumptyD: folds
Uncalled bet (20) returned to cllaytoon
cllaytoon collected 40 from pot
*** SUMMARY ***
Total pot 40 | Rake 0
Seat 1: HumptyD (button) (small blind) folded before Flop
Seat 2: cllaytoon (big blind) collected (40)

PokerStars Hand #251180728943: Tournament #3770707419, $0.46+$0.04 USD Hold'em No Limit - Level III (20/40) - 2024/06/24 20:20:04 ET
Table '3770707419 1' 3-max Seat #2 is the button
Seat 1: HumptyD (396 in chips)
Seat 2: cllaytoon (1104 in chips)
cllaytoon: posts small blind 20
HumptyD: posts big blind 40
*** HOLE CARDS ***
Dealt to HumptyD [Ks Jh]
cllaytoon: folds
Uncalled bet (20) returned to HumptyD
HumptyD collected 40 from pot
HumptyD: doesn't show hand
*** SUMMARY ***
Total pot 40 | Rake 0
Seat 1: HumptyD (big blind) collected (40)
Seat 2: cllaytoon (button) (small blind) folded before Flop

PokerStars Hand #251180729857: Tournament #3770707419, $0.46+$0.04 USD Hold'em No Limit - Level III (20/40) - 2024/06/24 20:20:10 ET
Table '3770707419 1' 3-max Seat #1 is the button
Seat 1: HumptyD (416 in chips)
Seat 2: cllaytoon (1084 in chips)
HumptyD: posts small blind 20
cllaytoon: posts big blind 40
*** HOLE CARDS ***
Dealt to HumptyD [2h 7s]
HumptyD: folds
Uncalled bet (20) returned to cllaytoon
cllaytoon collected 40 from pot
*** SUMMARY ***
Total pot 40 | Rake 0
Seat 1: HumptyD (button) (small blind) folded before Flop
Seat 2: cllaytoon (big blind) collected (40)

PokerStars Hand #251180731058: Tournament #3770707419, $0.46+$0.04 USD Hold'em No Limit - Level III (20/40) - 2024/06/24 20:20:17 ET
Table '3770707419 1' 3-max Seat #2 is the button
Seat 1: HumptyD (396 in chips)
Seat 2: cllaytoon (1104 in chips)
cllaytoon: posts small blind 20
HumptyD: posts big blind 40
*** HOLE CARDS ***
Dealt to HumptyD [8h Ac]
cllaytoon: calls 20
HumptyD: raises 356 to 396 and is all-in
cllaytoon: folds
Uncalled bet (356) returned to HumptyD
HumptyD collected 80 from pot
HumptyD: doesn't show hand
*** SUMMARY ***
Total pot 80 | Rake 0
Seat 1: HumptyD (big blind) collected (80)
Seat 2: cllaytoon (button) (small blind) folded before Flop

PokerStars Hand #251180732751: Tournament #3770707419, $0.46+$0.04 USD Hold'em No Limit - Level III (20/40) - 2024/06/24 20:20:27 ET
Table '3770707419 1' 3-max Seat #1 is the button
Seat 1: HumptyD (436 in chips)
Seat 2: cllaytoon (1064 in chips)
HumptyD: posts small blind 20
cllaytoon: posts big blind 40
*** HOLE CARDS ***
Dealt to HumptyD [9c Qd]
HumptyD: calls 20
cllaytoon: checks
*** FLOP *** [Th 7s Ad]
cllaytoon: checks
HumptyD: bets 40
cllaytoon: calls 40
*** TURN *** [Th 7s Ad] [Td]
cllaytoon: checks
HumptyD: checks
*** RIVER *** [Th 7s Ad Td] [8h]
cllaytoon: checks
HumptyD: checks
*** SHOW DOWN ***
cllaytoon: shows [3d 7h] (two pair, Tens and Sevens)
HumptyD: mucks hand
cllaytoon collected 160 from pot
*** SUMMARY ***
Total pot 160 | Rake 0
Board [Th 7s Ad Td 8h]
Seat 1: HumptyD (button) (small blind) mucked [9c Qd]
Seat 2: cllaytoon (big blind) showed [3d 7h] and won (160) with two pair, Tens and Sevens

PokerStars Hand #251180739098: Tournament #3770707419, $0.46+$0.04 USD Hold'em No Limit - Level IV (30/60) - 2024/06/24 20:21:03 ET
Table '3770707419 1' 3-max Seat #2 is the button
Seat 1: HumptyD (356 in chips)
Seat 2: cllaytoon (1144 in chips)
cllaytoon: posts small blind 30
HumptyD: posts big blind 60
*** HOLE CARDS ***
Dealt to HumptyD [9c 5d]
cllaytoon: calls 30
HumptyD: checks
*** FLOP *** [3d 2h Tc]
HumptyD: checks
cllaytoon: bets 60
HumptyD: folds
Uncalled bet (60) returned to cllaytoon
cllaytoon collected 120 from pot
*** SUMMARY ***
Total pot 120 | Rake 0
Board [3d 2h Tc]
Seat 1: HumptyD (big blind) folded on the Flop
Seat 2: cllaytoon (button) (small blind) collected (120)

PokerStars Hand #251180741637: Tournament #3770707419, $0.46+$0.04 USD Hold'em No Limit - Level IV (30/60) - 2024/06/24 20:21:17 ET
Table '3770707419 1' 3-max Seat #1 is the button
Seat 1: HumptyD (296 in chips)
Seat 2: cllaytoon (1204 in chips)
HumptyD: posts small blind 30
cllaytoon: posts big blind 60
*** HOLE CARDS ***
Dealt to HumptyD [Td Qc]
HumptyD: raises 236 to 296 and is all-in
cllaytoon: folds
Uncalled bet (236) returned to HumptyD
HumptyD collected 120 from pot
HumptyD: doesn't show hand
*** SUMMARY ***
Total pot 120 | Rake 0
Seat 1: HumptyD (button) (small blind) collected (120)
Seat 2: cllaytoon (big blind) folded before Flop

PokerStars Hand #251180744604: Tournament #3770707419, $0.46+$0.04 USD Hold'em No Limit - Level IV (30/60) - 2024/06/24 20:21:34 ET
Table '3770707419 1' 3-max Seat #2 is the button
Seat 1: HumptyD (356 in chips)
Seat 2: cllaytoon (1144 in chips)
cllaytoon: posts small blind 30
HumptyD: posts big blind 60
*** HOLE CARDS ***
Dealt to HumptyD [6s Qs]
cllaytoon: raises 1084 to 1144 and is all-in
HumptyD: calls 296 and is all-in
Uncalled bet (788) returned to cllaytoon
*** FLOP *** [Ks 4c 6d]
*** TURN *** [Ks 4c 6d] [5c]
*** RIVER *** [Ks 4c 6d 5c] [7h]
*** SHOW DOWN ***
HumptyD: shows [6s Qs] (a pair of Sixes)
cllaytoon: shows [8c Ah] (a straight, Four to Eight)
cllaytoon collected 712 from pot
HumptyD finished the tournament in 2nd place
cllaytoon wins the tournament - congratulations!
cllaytoon wins a '$1.50 Power Path Step 2 Ticket' ticket
*** SUMMARY ***
Total pot 712 | Rake 0
Board [Ks 4c 6d 5c 7h]
Seat 1: HumptyD (big blind) showed [6s Qs] and lost with a pair of Sixes
Seat 2: cllaytoon (button) (small blind) showed [8c Ah] and won (712) with a straight, Four to Eight


Hand ID: 7

PokerStars Hand #251180672387: Tournament #3770707480, $0.46+$0.04 USD Hold'em No Limit - Level I (10/20) - 2024/06/24 20:14:42 ET
Table '3770707480 1' 3-max Seat #1 is the button
Seat 1: cami11e (500 in chips)
Seat 2: HumptyD (500 in chips)
Seat 3: pelletier112 (500 in chips)
HumptyD: posts small blind 10
pelletier112: posts big blind 20
*** HOLE CARDS ***
Dealt to HumptyD [8h 9h]
cami11e: calls 20
HumptyD: calls 10
pelletier112: checks
*** FLOP *** [6s Th 8s]
HumptyD: checks
pelletier112: bets 60
cami11e: calls 60
HumptyD: folds
*** TURN *** [6s Th 8s] [Tc]
pelletier112: bets 20
cami11e: calls 20
*** RIVER *** [6s Th 8s Tc] [Qs]
pelletier112: bets 20
cami11e: folds
Uncalled bet (20) returned to pelletier112
pelletier112 collected 220 from pot
pelletier112: doesn't show hand
*** SUMMARY ***
Total pot 220 | Rake 0
Board [6s Th 8s Tc Qs]
Seat 1: cami11e (button) folded on the River
Seat 2: HumptyD (small blind) folded on the Flop
Seat 3: pelletier112 (big blind) collected (220)

PokerStars Hand #251180682411: Tournament #3770707480, $0.46+$0.04 USD Hold'em No Limit - Level I (10/20) - 2024/06/24 20:15:38 ET
Table '3770707480 1' 3-max Seat #2 is the button
Seat 1: cami11e (400 in chips)
Seat 2: HumptyD (480 in chips)
Seat 3: pelletier112 (620 in chips)
pelletier112: posts small blind 10
cami11e: posts big blind 20
*** HOLE CARDS ***
Dealt to HumptyD [Qc Qh]
HumptyD: raises 20 to 40
pelletier112: folds
cami11e: calls 20
*** FLOP *** [Kc Td Ac]
cami11e: bets 20
HumptyD: calls 20
*** TURN *** [Kc Td Ac] [2h]
cami11e: bets 130
HumptyD: calls 130
*** RIVER *** [Kc Td Ac 2h] [2c]
cami11e: bets 210 and is all-in
HumptyD: folds
Uncalled bet (210) returned to cami11e
cami11e collected 390 from pot
cami11e: doesn't show hand
*** SUMMARY ***
Total pot 390 | Rake 0
Board [Kc Td Ac 2h 2c]
Seat 1: cami11e (big blind) collected (390)
Seat 2: HumptyD (button) folded on the River
Seat 3: pelletier112 (small blind) folded before Flop

PokerStars Hand #251180691252: Tournament #3770707480, $0.46+$0.04 USD Hold'em No Limit - Level I (10/20) - 2024/06/24 20:16:28 ET
Table '3770707480 1' 3-max Seat #3 is the button
Seat 1: cami11e (600 in chips)
Seat 2: HumptyD (290 in chips)
Seat 3: pelletier112 (610 in chips)
cami11e: posts small blind 10
HumptyD: posts big blind 20
*** HOLE CARDS ***
Dealt to HumptyD [Td 7h]
pelletier112: folds
cami11e: calls 10
HumptyD: checks
*** FLOP *** [8h 3c Ad]
cami11e: bets 20
HumptyD: folds
Uncalled bet (20) returned to cami11e
cami11e collected 40 from pot
cami11e: doesn't show hand
*** SUMMARY ***
Total pot 40 | Rake 0
Board [8h 3c Ad]
Seat 1: cami11e (small blind) collected (40)
Seat 2: HumptyD (big blind) folded on the Flop
Seat 3: pelletier112 (button) folded before Flop (didn't bet)

PokerStars Hand #251180693867: Tournament #3770707480, $0.46+$0.04 USD Hold'em No Limit - Level I (10/20) - 2024/06/24 20:16:43 ET
Table '3770707480 1' 3-max Seat #1 is the button
Seat 1: cami11e (620 in chips)
Seat 2: HumptyD (270 in chips)
Seat 3: pelletier112 (610 in chips)
HumptyD: posts small blind 10
pelletier112: posts big blind 20
*** HOLE CARDS ***
Dealt to HumptyD [Ts 5d]
cami11e has timed out
cami11e: folds
cami11e is sitting out
cami11e has returned
HumptyD: folds
Uncalled bet (10) returned to pelletier112
pelletier112 collected 20 from pot
pelletier112: doesn't show hand
*** SUMMARY ***
Total pot 20 | Rake 0
Seat 1: cami11e (button) folded before Flop (didn't bet)
Seat 2: HumptyD (small blind) folded before Flop
Seat 3: pelletier112 (big blind) collected (20)

PokerStars Hand #251180697698: Tournament #3770707480, $0.46+$0.04 USD Hold'em No Limit - Level II (15/30) - 2024/06/24 20:17:05 ET
Table '3770707480 1' 3-max Seat #2 is the button
Seat 1: cami11e (620 in chips)
Seat 2: HumptyD (260 in chips)
Seat 3: pelletier112 (620 in chips)
pelletier112: posts small blind 15
cami11e: posts big blind 30
*** HOLE CARDS ***
Dealt to HumptyD [9h 3h]
HumptyD: folds
pelletier112: raises 60 to 90
cami11e: calls 60
*** FLOP *** [Jd 9d Th]
pelletier112: checks
cami11e: bets 30
pelletier112: calls 30
*** TURN *** [Jd 9d Th] [2h]
pelletier112: checks
cami11e has timed out
cami11e: checks
*** RIVER *** [Jd 9d Th 2h] [Ts]
pelletier112: checks
cami11e: checks
*** SHOW DOWN ***
pelletier112: shows [8h 8d] (two pair, Tens and Eights)
cami11e: mucks hand
pelletier112 collected 240 from pot
*** SUMMARY ***
Total pot 240 | Rake 0
Board [Jd 9d Th 2h Ts]
Seat 1: cami11e (big blind) mucked [4c 4s]
Seat 2: HumptyD (button) folded before Flop (didn't bet)
Seat 3: pelletier112 (small blind) showed [8h 8d] and won (240) with two pair, Tens and Eights

PokerStars Hand #251180708802: Tournament #3770707480, $0.46+$0.04 USD Hold'em No Limit - Level II (15/30) - 2024/06/24 20:18:09 ET
Table '3770707480 1' 3-max Seat #3 is the button
Seat 1: cami11e (500 in chips)
Seat 2: HumptyD (260 in chips)
Seat 3: pelletier112 (740 in chips)
cami11e: posts small blind 15
HumptyD: posts big blind 30
*** HOLE CARDS ***
Dealt to HumptyD [Kc 3s]
pelletier112: folds
cami11e: calls 15
HumptyD: checks
*** FLOP *** [6d Qs 8s]
cami11e has timed out
cami11e: checks
HumptyD: checks
*** TURN *** [6d Qs 8s] [Ts]
cami11e has timed out
cami11e: checks
HumptyD: checks
*** RIVER *** [6d Qs 8s Ts] [Ah]
cami11e: checks
HumptyD: checks
*** SHOW DOWN ***
cami11e: shows [9s As] (a flush, Ace high)
HumptyD: mucks hand
cami11e collected 60 from pot
*** SUMMARY ***
Total pot 60 | Rake 0
Board [6d Qs 8s Ts Ah]
Seat 1: cami11e (small blind) showed [9s As] and won (60) with a flush, Ace high
Seat 2: HumptyD (big blind) mucked [Kc 3s]
Seat 3: pelletier112 (button) folded before Flop (didn't bet)

PokerStars Hand #251180719023: Tournament #3770707480, $0.46+$0.04 USD Hold'em No Limit - Level III (20/40) - 2024/06/24 20:19:07 ET
Table '3770707480 1' 3-max Seat #1 is the button
Seat 1: cami11e (530 in chips)
Seat 2: HumptyD (230 in chips)
Seat 3: pelletier112 (740 in chips)
HumptyD: posts small blind 20
pelletier112: posts big blind 40
*** HOLE CARDS ***
Dealt to HumptyD [8s 3d]
cami11e: calls 40
HumptyD: folds
pelletier112: checks
*** FLOP *** [Ad Qs Td]
pelletier112: checks
cami11e: bets 80
pelletier112: folds
Uncalled bet (80) returned to cami11e
cami11e collected 100 from pot
cami11e: doesn't show hand
*** SUMMARY ***
Total pot 100 | Rake 0
Board [Ad Qs Td]
Seat 1: cami11e (button) collected (100)
Seat 2: HumptyD (small blind) folded before Flop
Seat 3: pelletier112 (big blind) folded on the Flop

PokerStars Hand #251180722360: Tournament #3770707480, $0.46+$0.04 USD Hold'em No Limit - Level III (20/40) - 2024/06/24 20:19:26 ET
Table '3770707480 1' 3-max Seat #2 is the button
Seat 1: cami11e (590 in chips)
Seat 2: HumptyD (210 in chips)
Seat 3: pelletier112 (700 in chips)
pelletier112: posts small blind 20
cami11e: posts big blind 40
*** HOLE CARDS ***
Dealt to HumptyD [Kc 2s]
HumptyD: folds
pelletier112: folds
Uncalled bet (20) returned to cami11e
cami11e collected 40 from pot
cami11e: doesn't show hand
*** SUMMARY ***
Total pot 40 | Rake 0
Seat 1: cami11e (big blind) collected (40)
Seat 2: HumptyD (button) folded before Flop (didn't bet)
Seat 3: pelletier112 (small blind) folded before Flop

PokerStars Hand #251180723350: Tournament #3770707480, $0.46+$0.04 USD Hold'em No Limit - Level III (20/40) - 2024/06/24 20:19:32 ET
Table '3770707480 1' 3-max Seat #3 is the button
Seat 1: cami11e (610 in chips)
Seat 2: HumptyD (210 in chips)
Seat 3: pelletier112 (680 in chips)
cami11e: posts small blind 20
HumptyD: posts big blind 40
*** HOLE CARDS ***
Dealt to HumptyD [8d 6s]
pelletier112: folds
cami11e has timed out
cami11e: folds
cami11e is sitting out
Uncalled bet (20) returned to HumptyD
HumptyD collected 40 from pot
HumptyD: doesn't show hand
*** SUMMARY ***
Total pot 40 | Rake 0
Seat 1: cami11e (small blind) folded before Flop
Seat 2: HumptyD (big blind) collected (40)
Seat 3: pelletier112 (button) folded before Flop (didn't bet)

PokerStars Hand #251180726446: Tournament #3770707480, $0.46+$0.04 USD Hold'em No Limit - Level III (20/40) - 2024/06/24 20:19:50 ET
Table '3770707480 1' 3-max Seat #1 is the button
Seat 1: cami11e (590 in chips) is sitting out
Seat 2: HumptyD (230 in chips)
Seat 3: pelletier112 (680 in chips)
HumptyD: posts small blind 20
pelletier112: posts big blind 40
*** HOLE CARDS ***
Dealt to HumptyD [Jd 3d]
cami11e: folds
HumptyD: calls 20
pelletier112: checks
*** FLOP *** [Ad Tc Qd]
HumptyD: bets 40
pelletier112: raises 160 to 200
HumptyD: calls 150 and is all-in
Uncalled bet (10) returned to pelletier112
*** TURN *** [Ad Tc Qd] [9s]
*** RIVER *** [Ad Tc Qd 9s] [3h]
*** SHOW DOWN ***
HumptyD: shows [Jd 3d] (a pair of Threes)
pelletier112: shows [Jh Ac] (a pair of Aces)
pelletier112 collected 460 from pot
HumptyD finished the tournament in 3rd place
*** SUMMARY ***
Total pot 460 | Rake 0
Board [Ad Tc Qd 9s 3h]
Seat 1: cami11e (button) folded before Flop (didn't bet)
Seat 2: HumptyD (small blind) showed [Jd 3d] and lost with a pair of Threes
Seat 3: pelletier112 (big blind) showed [Jh Ac] and won (460) with a pair of Aces


Hand ID: 8

PokerStars Hand #251180682637: Tournament #3770707700, $0.46+$0.04 USD Hold'em No Limit - Level I (10/20) - 2024/06/24 20:15:40 ET
Table '3770707700 1' 3-max Seat #1 is the button
Seat 1: stevey purr (500 in chips)
Seat 2: HumptyD (500 in chips)
Seat 3: Helderx17 (500 in chips)
HumptyD: posts small blind 10
Helderx17: posts big blind 20
*** HOLE CARDS ***
Dealt to HumptyD [9s Jh]
stevey purr: calls 20
HumptyD: folds
Helderx17: raises 20 to 40
stevey purr: calls 20
*** FLOP *** [Ah 8s 8c]
Helderx17: bets 20
stevey purr: calls 20
*** TURN *** [Ah 8s 8c] [Js]
Helderx17: bets 20
stevey purr: calls 20
*** RIVER *** [Ah 8s 8c Js] [4s]
Helderx17: bets 20
stevey purr: calls 20
*** SHOW DOWN ***
Helderx17: shows [7h As] (two pair, Aces and Eights)
stevey purr: mucks hand
Helderx17 collected 210 from pot
*** SUMMARY ***
Total pot 210 | Rake 0
Board [Ah 8s 8c Js 4s]
Seat 1: stevey purr (button) mucked [Kd 9h]
Seat 2: HumptyD (small blind) folded before Flop
Seat 3: Helderx17 (big blind) showed [7h As] and won (210) with two pair, Aces and Eights

PokerStars Hand #251180689616: Tournament #3770707700, $0.46+$0.04 USD Hold'em No Limit - Level I (10/20) - 2024/06/24 20:16:19 ET
Table '3770707700 1' 3-max Seat #2 is the button
Seat 1: stevey purr (400 in chips)
Seat 2: HumptyD (490 in chips)
Seat 3: Helderx17 (610 in chips)
Helderx17: posts small blind 10
stevey purr: posts big blind 20
*** HOLE CARDS ***
Dealt to HumptyD [9h Ts]
HumptyD: raises 20 to 40
Helderx17: calls 30
stevey purr: raises 20 to 60
HumptyD: calls 20
Helderx17: calls 20
*** FLOP *** [6d Kh 7c]
Helderx17: checks
stevey purr: checks
HumptyD: bets 45
Helderx17: folds
stevey purr: calls 45
*** TURN *** [6d Kh 7c] [9c]
stevey purr: checks
HumptyD: checks
*** RIVER *** [6d Kh 7c 9c] [4d]
stevey purr: bets 295 and is all-in
HumptyD: calls 295
*** SHOW DOWN ***
stevey purr: shows [As 2s] (high card Ace)
HumptyD: shows [9h Ts] (a pair of Nines)
HumptyD collected 860 from pot
stevey purr finished the tournament in 3rd place
*** SUMMARY ***
Total pot 860 | Rake 0
Board [6d Kh 7c 9c 4d]
Seat 1: stevey purr (big blind) showed [As 2s] and lost with high card Ace
Seat 2: HumptyD (button) showed [9h Ts] and won (860) with a pair of Nines
Seat 3: Helderx17 (small blind) folded on the Flop

PokerStars Hand #251180702096: Tournament #3770707700, $0.46+$0.04 USD Hold'em No Limit - Level I (10/20) - 2024/06/24 20:17:30 ET
Table '3770707700 1' 3-max Seat #3 is the button
Seat 2: HumptyD (950 in chips)
Seat 3: Helderx17 (550 in chips)
Helderx17: posts small blind 10
HumptyD: posts big blind 20
*** HOLE CARDS ***
Dealt to HumptyD [Ac Kc]
Helderx17: calls 10
HumptyD: raises 40 to 60
Helderx17: raises 40 to 100
HumptyD: raises 850 to 950 and is all-in
Helderx17: calls 450 and is all-in
Uncalled bet (400) returned to HumptyD
*** FLOP *** [2s Td Kh]
*** TURN *** [2s Td Kh] [7h]
*** RIVER *** [2s Td Kh 7h] [6c]
*** SHOW DOWN ***
HumptyD: shows [Ac Kc] (a pair of Kings)
Helderx17: shows [9d 9s] (a pair of Nines)
HumptyD collected 1100 from pot
Helderx17 finished the tournament in 2nd place
HumptyD wins the tournament - congratulations!
HumptyD wins a '$1.50 Power Path Step 2 Ticket' ticket
*** SUMMARY ***
Total pot 1100 | Rake 0
Board [2s Td Kh 7h 6c]
Seat 2: HumptyD (big blind) showed [Ac Kc] and won (1100) with a pair of Kings
Seat 3: Helderx17 (button) (small blind) showed [9d 9s] and lost with a pair of Nines


Hand ID: 9

PokerStars Hand #251180687964: Tournament #3770707834, $0.23+$0.02 USD Hold'em No Limit - Level I (10/20) - 2024/06/24 20:16:10 ET
Table '3770707834 1' 3-max Seat #1 is the button
Seat 1: donk kong 171 (500 in chips)
Seat 2: gosanti1 (500 in chips)
Seat 3: HumptyD (500 in chips)
gosanti1: posts small blind 10
HumptyD: posts big blind 20
*** HOLE CARDS ***
Dealt to HumptyD [7d 3h]
donk kong 171: folds
gosanti1: calls 10
HumptyD: checks
*** FLOP *** [6d Qs 9h]
gosanti1: bets 20
HumptyD: folds
Uncalled bet (20) returned to gosanti1
gosanti1 collected 40 from pot
*** SUMMARY ***
Total pot 40 | Rake 0
Board [6d Qs 9h]
Seat 1: donk kong 171 (button) folded before Flop (didn't bet)
Seat 2: gosanti1 (small blind) collected (40)
Seat 3: HumptyD (big blind) folded on the Flop

PokerStars Hand #251180692118: Tournament #3770707834, $0.23+$0.02 USD Hold'em No Limit - Level I (10/20) - 2024/06/24 20:16:33 ET
Table '3770707834 1' 3-max Seat #2 is the button
Seat 1: donk kong 171 (500 in chips)
Seat 2: gosanti1 (520 in chips)
Seat 3: HumptyD (480 in chips)
HumptyD: posts small blind 10
donk kong 171: posts big blind 20
*** HOLE CARDS ***
Dealt to HumptyD [8h 6h]
gosanti1: calls 20
HumptyD: calls 10
donk kong 171: checks
*** FLOP *** [9s Td 7d]
HumptyD: checks
donk kong 171: checks
gosanti1: bets 20
HumptyD: raises 40 to 60
donk kong 171: folds
gosanti1: calls 40
*** TURN *** [9s Td 7d] [7s]
HumptyD: bets 135
gosanti1: calls 135
*** RIVER *** [9s Td 7d 7s] [5c]
HumptyD: bets 265 and is all-in
gosanti1: folds
Uncalled bet (265) returned to HumptyD
HumptyD collected 450 from pot
HumptyD: doesn't show hand
*** SUMMARY ***
Total pot 450 | Rake 0
Board [9s Td 7d 7s 5c]
Seat 1: donk kong 171 (big blind) folded on the Flop
Seat 2: gosanti1 (button) folded on the River
Seat 3: HumptyD (small blind) collected (450)

PokerStars Hand #251180699224: Tournament #3770707834, $0.23+$0.02 USD Hold'em No Limit - Level I (10/20) - 2024/06/24 20:17:14 ET
Table '3770707834 1' 3-max Seat #3 is the button
Seat 1: donk kong 171 (480 in chips)
Seat 2: gosanti1 (305 in chips)
Seat 3: HumptyD (715 in chips)
donk kong 171: posts small blind 10
gosanti1: posts big blind 20
*** HOLE CARDS ***
Dealt to HumptyD [4d Tc]
HumptyD: folds
donk kong 171: calls 10
gosanti1: checks
*** FLOP *** [5c 8h As]
donk kong 171: checks
gosanti1: bets 20
donk kong 171: calls 20
*** TURN *** [5c 8h As] [2h]
donk kong 171: checks
gosanti1: bets 20
donk kong 171: folds
Uncalled bet (20) returned to gosanti1
gosanti1 collected 80 from pot
*** SUMMARY ***
Total pot 80 | Rake 0
Board [5c 8h As 2h]
Seat 1: donk kong 171 (small blind) folded on the Turn
Seat 2: gosanti1 (big blind) collected (80)
Seat 3: HumptyD (button) folded before Flop (didn't bet)

PokerStars Hand #251180707664: Tournament #3770707834, $0.23+$0.02 USD Hold'em No Limit - Level I (10/20) - 2024/06/24 20:18:02 ET
Table '3770707834 1' 3-max Seat #1 is the button
Seat 1: donk kong 171 (440 in chips)
Seat 2: gosanti1 (345 in chips)
Seat 3: HumptyD (715 in chips)
gosanti1: posts small blind 10
HumptyD: posts big blind 20
*** HOLE CARDS ***
Dealt to HumptyD [Td 5c]
donk kong 171: calls 20
gosanti1: calls 10
HumptyD: checks
*** FLOP *** [Ah Qs Kc]
gosanti1: checks
HumptyD: checks
donk kong 171: checks
*** TURN *** [Ah Qs Kc] [7h]
gosanti1: checks
HumptyD: checks
donk kong 171: checks
*** RIVER *** [Ah Qs Kc 7h] [9s]
gosanti1: checks
HumptyD: checks
donk kong 171: checks
*** SHOW DOWN ***
gosanti1: shows [6h Jh] (high card Ace)
HumptyD: mucks hand
donk kong 171: shows [2s 2c] (a pair of Deuces)
donk kong 171 collected 60 from pot
*** SUMMARY ***
Total pot 60 | Rake 0
Board [Ah Qs Kc 7h 9s]
Seat 1: donk kong 171 (button) showed [2s 2c] and won (60) with a pair of Deuces
Seat 2: gosanti1 (small blind) showed [6h Jh] and lost with high card Ace
Seat 3: HumptyD (big blind) mucked [Td 5c]

PokerStars Hand #251180716566: Tournament #3770707834, $0.23+$0.02 USD Hold'em No Limit - Level II (15/30) - 2024/06/24 20:18:53 ET
Table '3770707834 1' 3-max Seat #2 is the button
Seat 1: donk kong 171 (480 in chips)
Seat 2: gosanti1 (325 in chips)
Seat 3: HumptyD (695 in chips)
HumptyD: posts small blind 15
donk kong 171: posts big blind 30
*** HOLE CARDS ***
Dealt to HumptyD [5c 4d]
gosanti1: folds
HumptyD: folds
Uncalled bet (15) returned to donk kong 171
donk kong 171 collected 30 from pot
*** SUMMARY ***
Total pot 30 | Rake 0
Seat 1: donk kong 171 (big blind) collected (30)
Seat 2: gosanti1 (button) folded before Flop (didn't bet)
Seat 3: HumptyD (small blind) folded before Flop

PokerStars Hand #251180719625: Tournament #3770707834, $0.23+$0.02 USD Hold'em No Limit - Level II (15/30) - 2024/06/24 20:19:10 ET
Table '3770707834 1' 3-max Seat #3 is the button
Seat 1: donk kong 171 (495 in chips)
Seat 2: gosanti1 (325 in chips)
Seat 3: HumptyD (680 in chips)
donk kong 171: posts small blind 15
gosanti1: posts big blind 30
*** HOLE CARDS ***
Dealt to HumptyD [3d 5s]
HumptyD: folds
donk kong 171: calls 15
gosanti1: checks
*** FLOP *** [Kd Td Tc]
donk kong 171: bets 60
gosanti1: folds
Uncalled bet (60) returned to donk kong 171
donk kong 171 collected 60 from pot
*** SUMMARY ***
Total pot 60 | Rake 0
Board [Kd Td Tc]
Seat 1: donk kong 171 (small blind) collected (60)
Seat 2: gosanti1 (big blind) folded on the Flop
Seat 3: HumptyD (button) folded before Flop (didn't bet)

PokerStars Hand #251180723127: Tournament #3770707834, $0.23+$0.02 USD Hold'em No Limit - Level II (15/30) - 2024/06/24 20:19:31 ET
Table '3770707834 1' 3-max Seat #1 is the button
Seat 1: donk kong 171 (525 in chips)
Seat 2: gosanti1 (295 in chips)
Seat 3: HumptyD (680 in chips)
gosanti1: posts small blind 15
HumptyD: posts big blind 30
*** HOLE CARDS ***
Dealt to HumptyD [4d 5d]
donk kong 171: folds
gosanti1: calls 15
HumptyD: raises 30 to 60
gosanti1: calls 30
*** FLOP *** [2s 7s Th]
gosanti1: checks
HumptyD: checks
*** TURN *** [2s 7s Th] [Ah]
gosanti1: checks
HumptyD: checks
*** RIVER *** [2s 7s Th Ah] [6c]
gosanti1: checks
HumptyD: checks
*** SHOW DOWN ***
gosanti1: shows [Qc 8h] (high card Ace)
HumptyD: mucks hand
gosanti1 collected 120 from pot
*** SUMMARY ***
Total pot 120 | Rake 0
Board [2s 7s Th Ah 6c]
Seat 1: donk kong 171 (button) folded before Flop (didn't bet)
Seat 2: gosanti1 (small blind) showed [Qc 8h] and won (120) with high card Ace
Seat 3: HumptyD (big blind) mucked [4d 5d]

PokerStars Hand #251180729750: Tournament #3770707834, $0.23+$0.02 USD Hold'em No Limit - Level II (15/30) - 2024/06/24 20:20:09 ET
Table '3770707834 1' 3-max Seat #2 is the button
Seat 1: donk kong 171 (525 in chips)
Seat 2: gosanti1 (355 in chips)
Seat 3: HumptyD (620 in chips)
HumptyD: posts small blind 15
donk kong 171: posts big blind 30
*** HOLE CARDS ***
Dealt to HumptyD [Kc 4s]
gosanti1: folds
HumptyD: folds
Uncalled bet (15) returned to donk kong 171
donk kong 171 collected 30 from pot
*** SUMMARY ***
Total pot 30 | Rake 0
Seat 1: donk kong 171 (big blind) collected (30)
Seat 2: gosanti1 (button) folded before Flop (didn't bet)
Seat 3: HumptyD (small blind) folded before Flop

PokerStars Hand #251180732256: Tournament #3770707834, $0.23+$0.02 USD Hold'em No Limit - Level III (20/40) - 2024/06/24 20:20:24 ET
Table '3770707834 1' 3-max Seat #3 is the button
Seat 1: donk kong 171 (540 in chips)
Seat 2: gosanti1 (355 in chips)
Seat 3: HumptyD (605 in chips)
donk kong 171: posts small blind 20
gosanti1: posts big blind 40
*** HOLE CARDS ***
Dealt to HumptyD [Jc Ts]
HumptyD: raises 40 to 80
donk kong 171: folds
gosanti1: folds
Uncalled bet (40) returned to HumptyD
HumptyD collected 100 from pot
HumptyD: doesn't show hand
*** SUMMARY ***
Total pot 100 | Rake 0
Seat 1: donk kong 171 (small blind) folded before Flop
Seat 2: gosanti1 (big blind) folded before Flop
Seat 3: HumptyD (button) collected (100)

PokerStars Hand #251180734998: Tournament #3770707834, $0.23+$0.02 USD Hold'em No Limit - Level III (20/40) - 2024/06/24 20:20:39 ET
Table '3770707834 1' 3-max Seat #1 is the button
Seat 1: donk kong 171 (520 in chips)
Seat 2: gosanti1 (315 in chips)
Seat 3: HumptyD (665 in chips)
gosanti1: posts small blind 20
HumptyD: posts big blind 40
*** HOLE CARDS ***
Dealt to HumptyD [5h 9c]
donk kong 171: folds
gosanti1: raises 40 to 80
HumptyD: folds
Uncalled bet (40) returned to gosanti1
gosanti1 collected 80 from pot
*** SUMMARY ***
Total pot 80 | Rake 0
Seat 1: donk kong 171 (button) folded before Flop (didn't bet)
Seat 2: gosanti1 (small blind) collected (80)
Seat 3: HumptyD (big blind) folded before Flop

PokerStars Hand #251180736249: Tournament #3770707834, $0.23+$0.02 USD Hold'em No Limit - Level III (20/40) - 2024/06/24 20:20:47 ET
Table '3770707834 1' 3-max Seat #2 is the button
Seat 1: donk kong 171 (520 in chips)
Seat 2: gosanti1 (355 in chips)
Seat 3: HumptyD (625 in chips)
HumptyD: posts small blind 20
donk kong 171: posts big blind 40
*** HOLE CARDS ***
Dealt to HumptyD [Jd 5c]
gosanti1: calls 40
HumptyD: folds
donk kong 171: checks
*** FLOP *** [Ah Ad 7s]
donk kong 171: checks
gosanti1: checks
*** TURN *** [Ah Ad 7s] [Qc]
donk kong 171: checks
gosanti1: bets 40
donk kong 171: folds
Uncalled bet (40) returned to gosanti1
gosanti1 collected 100 from pot
*** SUMMARY ***
Total pot 100 | Rake 0
Board [Ah Ad 7s Qc]
Seat 1: donk kong 171 (big blind) folded on the Turn
Seat 2: gosanti1 (button) collected (100)
Seat 3: HumptyD (small blind) folded before Flop

PokerStars Hand #251180743096: Tournament #3770707834, $0.23+$0.02 USD Hold'em No Limit - Level III (20/40) - 2024/06/24 20:21:25 ET
Table '3770707834 1' 3-max Seat #3 is the button
Seat 1: donk kong 171 (480 in chips)
Seat 2: gosanti1 (415 in chips)
Seat 3: HumptyD (605 in chips)
donk kong 171: posts small blind 20
gosanti1: posts big blind 40
*** HOLE CARDS ***
Dealt to HumptyD [4c Kd]
HumptyD: folds
donk kong 171: folds
Uncalled bet (20) returned to gosanti1
gosanti1 collected 40 from pot
*** SUMMARY ***
Total pot 40 | Rake 0
Seat 1: donk kong 171 (small blind) folded before Flop
Seat 2: gosanti1 (big blind) collected (40)
Seat 3: HumptyD (button) folded before Flop (didn't bet)

PokerStars Hand #251180744588: Tournament #3770707834, $0.23+$0.02 USD Hold'em No Limit - Level III (20/40) - 2024/06/24 20:21:34 ET
Table '3770707834 1' 3-max Seat #1 is the button
Seat 1: donk kong 171 (460 in chips)
Seat 2: gosanti1 (435 in chips)
Seat 3: HumptyD (605 in chips)
gosanti1: posts small blind 20
HumptyD: posts big blind 40
*** HOLE CARDS ***
Dealt to HumptyD [8d Jc]
donk kong 171: folds
gosanti1: calls 20
HumptyD: checks
*** FLOP *** [4h 3c 2c]
gosanti1: bets 40
HumptyD: folds
Uncalled bet (40) returned to gosanti1
gosanti1 collected 80 from pot
*** SUMMARY ***
Total pot 80 | Rake 0
Board [4h 3c 2c]
Seat 1: donk kong 171 (button) folded before Flop (didn't bet)
Seat 2: gosanti1 (small blind) collected (80)
Seat 3: HumptyD (big blind) folded on the Flop

PokerStars Hand #251180749758: Tournament #3770707834, $0.23+$0.02 USD Hold'em No Limit - Level III (20/40) - 2024/06/24 20:22:03 ET
Table '3770707834 1' 3-max Seat #2 is the button
Seat 1: donk kong 171 (460 in chips)
Seat 2: gosanti1 (475 in chips)
Seat 3: HumptyD (565 in chips)
HumptyD: posts small blind 20
donk kong 171: posts big blind 40
*** HOLE CARDS ***
Dealt to HumptyD [9s 8h]
gosanti1: calls 40
HumptyD: folds
donk kong 171: checks
*** FLOP *** [7c 2c 2d]
donk kong 171: checks
gosanti1: checks
*** TURN *** [7c 2c 2d] [5h]
donk kong 171: checks
gosanti1: checks
*** RIVER *** [7c 2c 2d 5h] [5c]
donk kong 171: checks
gosanti1: checks
*** SHOW DOWN ***
donk kong 171: shows [3c Jh] (two pair, Fives and Deuces)
gosanti1: mucks hand
donk kong 171 collected 100 from pot
*** SUMMARY ***
Total pot 100 | Rake 0
Board [7c 2c 2d 5h 5c]
Seat 1: donk kong 171 (big blind) showed [3c Jh] and won (100) with two pair, Fives and Deuces
Seat 2: gosanti1 (button) mucked [3h Th]
Seat 3: HumptyD (small blind) folded before Flop

PokerStars Hand #251180754408: Tournament #3770707834, $0.23+$0.02 USD Hold'em No Limit - Level IV (30/60) - 2024/06/24 20:22:29 ET
Table '3770707834 1' 3-max Seat #3 is the button
Seat 1: donk kong 171 (520 in chips)
Seat 2: gosanti1 (435 in chips)
Seat 3: HumptyD (545 in chips)
donk kong 171: posts small blind 30
gosanti1: posts big blind 60
*** HOLE CARDS ***
Dealt to HumptyD [7c 6h]
HumptyD: folds
donk kong 171: folds
Uncalled bet (30) returned to gosanti1
gosanti1 collected 60 from pot
*** SUMMARY ***
Total pot 60 | Rake 0
Seat 1: donk kong 171 (small blind) folded before Flop
Seat 2: gosanti1 (big blind) collected (60)
Seat 3: HumptyD (button) folded before Flop (didn't bet)

PokerStars Hand #251180756382: Tournament #3770707834, $0.23+$0.02 USD Hold'em No Limit - Level IV (30/60) - 2024/06/24 20:22:40 ET
Table '3770707834 1' 3-max Seat #1 is the button
Seat 1: donk kong 171 (490 in chips)
Seat 2: gosanti1 (465 in chips)
Seat 3: HumptyD (545 in chips)
gosanti1: posts small blind 30
HumptyD: posts big blind 60
*** HOLE CARDS ***
Dealt to HumptyD [2s As]
donk kong 171: calls 60
gosanti1: calls 30
HumptyD: raises 485 to 545 and is all-in
donk kong 171: folds
gosanti1: folds
Uncalled bet (485) returned to HumptyD
HumptyD collected 180 from pot
HumptyD: doesn't show hand
*** SUMMARY ***
Total pot 180 | Rake 0
Seat 1: donk kong 171 (button) folded before Flop
Seat 2: gosanti1 (small blind) folded before Flop
Seat 3: HumptyD (big blind) collected (180)

PokerStars Hand #251180759388: Tournament #3770707834, $0.23+$0.02 USD Hold'em No Limit - Level IV (30/60) - 2024/06/24 20:22:57 ET
Table '3770707834 1' 3-max Seat #2 is the button
Seat 1: donk kong 171 (430 in chips)
Seat 2: gosanti1 (405 in chips)
Seat 3: HumptyD (665 in chips)
HumptyD: posts small blind 30
donk kong 171: posts big blind 60
*** HOLE CARDS ***
Dealt to HumptyD [Qh Qd]
gosanti1: calls 60
HumptyD: raises 605 to 665 and is all-in
donk kong 171: folds
gosanti1: folds
Uncalled bet (605) returned to HumptyD
HumptyD collected 180 from pot
HumptyD: doesn't show hand
*** SUMMARY ***
Total pot 180 | Rake 0
Seat 1: donk kong 171 (big blind) folded before Flop
Seat 2: gosanti1 (button) folded before Flop
Seat 3: HumptyD (small blind) collected (180)

PokerStars Hand #251180761890: Tournament #3770707834, $0.23+$0.02 USD Hold'em No Limit - Level IV (30/60) - 2024/06/24 20:23:11 ET
Table '3770707834 1' 3-max Seat #3 is the button
Seat 1: donk kong 171 (370 in chips)
Seat 2: gosanti1 (345 in chips)
Seat 3: HumptyD (785 in chips)
donk kong 171: posts small blind 30
gosanti1: posts big blind 60
*** HOLE CARDS ***
Dealt to HumptyD [3h 4h]
HumptyD: folds
donk kong 171: folds
Uncalled bet (30) returned to gosanti1
gosanti1 collected 60 from pot
*** SUMMARY ***
Total pot 60 | Rake 0
Seat 1: donk kong 171 (small blind) folded before Flop
Seat 2: gosanti1 (big blind) collected (60)
Seat 3: HumptyD (button) folded before Flop (didn't bet)

PokerStars Hand #251180763434: Tournament #3770707834, $0.23+$0.02 USD Hold'em No Limit - Level IV (30/60) - 2024/06/24 20:23:20 ET
Table '3770707834 1' 3-max Seat #1 is the button
Seat 1: donk kong 171 (340 in chips)
Seat 2: gosanti1 (375 in chips)
Seat 3: HumptyD (785 in chips)
gosanti1: posts small blind 30
HumptyD: posts big blind 60
*** HOLE CARDS ***
Dealt to HumptyD [9h 7h]
donk kong 171: calls 60
gosanti1: calls 30
HumptyD: checks
*** FLOP *** [Ad 9d 4h]
gosanti1: checks
HumptyD: checks
donk kong 171: bets 180
gosanti1: folds
HumptyD: calls 180
*** TURN *** [Ad 9d 4h] [2s]
HumptyD: checks
donk kong 171: bets 100 and is all-in
HumptyD: calls 100
*** RIVER *** [Ad 9d 4h 2s] [9c]
*** SHOW DOWN ***
HumptyD: shows [9h 7h] (three of a kind, Nines)
donk kong 171: shows [As 5s] (two pair, Aces and Nines)
HumptyD collected 740 from pot
donk kong 171 finished the tournament in 3rd place
*** SUMMARY ***
Total pot 740 | Rake 0
Board [Ad 9d 4h 2s 9c]
Seat 1: donk kong 171 (button) showed [As 5s] and lost with two pair, Aces and Nines
Seat 2: gosanti1 (small blind) folded on the Flop
Seat 3: HumptyD (big blind) showed [9h 7h] and won (740) with three of a kind, Nines

PokerStars Hand #251180770361: Tournament #3770707834, $0.23+$0.02 USD Hold'em No Limit - Level IV (30/60) - 2024/06/24 20:24:00 ET
Table '3770707834 1' 3-max Seat #3 is the button
Seat 2: gosanti1 (315 in chips)
Seat 3: HumptyD (1185 in chips)
HumptyD: posts small blind 30
gosanti1: posts big blind 60
*** HOLE CARDS ***
Dealt to HumptyD [9s Tc]
HumptyD: raises 1125 to 1185 and is all-in
gosanti1: folds
Uncalled bet (1125) returned to HumptyD
HumptyD collected 120 from pot
HumptyD: doesn't show hand
*** SUMMARY ***
Total pot 120 | Rake 0
Seat 2: gosanti1 (big blind) folded before Flop
Seat 3: HumptyD (button) (small blind) collected (120)

PokerStars Hand #251180772310: Tournament #3770707834, $0.23+$0.02 USD Hold'em No Limit - Level IV (30/60) - 2024/06/24 20:24:11 ET
Table '3770707834 1' 3-max Seat #2 is the button
Seat 2: gosanti1 (255 in chips)
Seat 3: HumptyD (1245 in chips)
gosanti1: posts small blind 30
HumptyD: posts big blind 60
*** HOLE CARDS ***
Dealt to HumptyD [2d 9c]
gosanti1: calls 30
HumptyD: checks
*** FLOP *** [Jc Td 7c]
HumptyD: checks
gosanti1: bets 60
HumptyD: folds
Uncalled bet (60) returned to gosanti1
gosanti1 collected 120 from pot
*** SUMMARY ***
Total pot 120 | Rake 0
Board [Jc Td 7c]
Seat 2: gosanti1 (button) (small blind) collected (120)
Seat 3: HumptyD (big blind) folded on the Flop

PokerStars Hand #251180775134: Tournament #3770707834, $0.23+$0.02 USD Hold'em No Limit - Level V (40/80) - 2024/06/24 20:24:26 ET
Table '3770707834 1' 3-max Seat #3 is the button
Seat 2: gosanti1 (315 in chips)
Seat 3: HumptyD (1185 in chips)
HumptyD: posts small blind 40
gosanti1: posts big blind 80
*** HOLE CARDS ***
Dealt to HumptyD [6c 5h]
HumptyD: folds
Uncalled bet (40) returned to gosanti1
gosanti1 collected 80 from pot
*** SUMMARY ***
Total pot 80 | Rake 0
Seat 2: gosanti1 (big blind) collected (80)
Seat 3: HumptyD (button) (small blind) folded before Flop

PokerStars Hand #251180775823: Tournament #3770707834, $0.23+$0.02 USD Hold'em No Limit - Level V (40/80) - 2024/06/24 20:24:30 ET
Table '3770707834 1' 3-max Seat #2 is the button
Seat 2: gosanti1 (355 in chips)
Seat 3: HumptyD (1145 in chips)
gosanti1: posts small blind 40
HumptyD: posts big blind 80
*** HOLE CARDS ***
Dealt to HumptyD [Ks 7s]
gosanti1: calls 40
HumptyD: raises 1065 to 1145 and is all-in
gosanti1: folds
Uncalled bet (1065) returned to HumptyD
HumptyD collected 160 from pot
HumptyD: doesn't show hand
*** SUMMARY ***
Total pot 160 | Rake 0
Seat 2: gosanti1 (button) (small blind) folded before Flop
Seat 3: HumptyD (big blind) collected (160)

PokerStars Hand #251180778490: Tournament #3770707834, $0.23+$0.02 USD Hold'em No Limit - Level V (40/80) - 2024/06/24 20:24:45 ET
Table '3770707834 1' 3-max Seat #3 is the button
Seat 2: gosanti1 (275 in chips)
Seat 3: HumptyD (1225 in chips)
HumptyD: posts small blind 40
gosanti1: posts big blind 80
*** HOLE CARDS ***
Dealt to HumptyD [5h 8d]
HumptyD: folds
Uncalled bet (40) returned to gosanti1
gosanti1 collected 80 from pot
*** SUMMARY ***
Total pot 80 | Rake 0
Seat 2: gosanti1 (big blind) collected (80)
Seat 3: HumptyD (button) (small blind) folded before Flop

PokerStars Hand #251180779107: Tournament #3770707834, $0.23+$0.02 USD Hold'em No Limit - Level V (40/80) - 2024/06/24 20:24:49 ET
Table '3770707834 1' 3-max Seat #2 is the button
Seat 2: gosanti1 (315 in chips)
Seat 3: HumptyD (1185 in chips)
gosanti1: posts small blind 40
HumptyD: posts big blind 80
*** HOLE CARDS ***
Dealt to HumptyD [5d 6s]
gosanti1: calls 40
HumptyD: checks
*** FLOP *** [Js 3h 6h]
HumptyD: checks
gosanti1: bets 235 and is all-in
HumptyD: folds
Uncalled bet (235) returned to gosanti1
gosanti1 collected 160 from pot
*** SUMMARY ***
Total pot 160 | Rake 0
Board [Js 3h 6h]
Seat 2: gosanti1 (button) (small blind) collected (160)
Seat 3: HumptyD (big blind) folded on the Flop

PokerStars Hand #251180783400: Tournament #3770707834, $0.23+$0.02 USD Hold'em No Limit - Level V (40/80) - 2024/06/24 20:25:14 ET
Table '3770707834 1' 3-max Seat #3 is the button
Seat 2: gosanti1 (395 in chips)
Seat 3: HumptyD (1105 in chips)
HumptyD: posts small blind 40
gosanti1: posts big blind 80
*** HOLE CARDS ***
Dealt to HumptyD [9s Th]
HumptyD: raises 1025 to 1105 and is all-in
gosanti1: calls 315 and is all-in
Uncalled bet (710) returned to HumptyD
*** FLOP *** [3d 8d Ts]
*** TURN *** [3d 8d Ts] [Td]
*** RIVER *** [3d 8d Ts Td] [8c]
*** SHOW DOWN ***
gosanti1: shows [Ah Qc] (two pair, Tens and Eights)
HumptyD: shows [9s Th] (a full house, Tens full of Eights)
HumptyD collected 790 from pot
gosanti1 finished the tournament in 2nd place
HumptyD wins the tournament and receives $0.50 - congratulations!
*** SUMMARY ***
Total pot 790 | Rake 0
Board [3d 8d Ts Td 8c]
Seat 2: gosanti1 (big blind) showed [Ah Qc] and lost with two pair, Tens and Eights
Seat 3: HumptyD (button) (small blind) showed [9s Th] and won (790) with a full house, Tens full of Eights


Hand ID: 10

PokerStars Hand #251180718664: Tournament #3770708484, $0.46+$0.04 USD Hold'em No Limit - Level I (10/20) - 2024/06/24 20:19:05 ET
Table '3770708484 1' 3-max Seat #1 is the button
Seat 1: Weronika93 (500 in chips)
Seat 2: HumptyD (500 in chips)
Seat 3: niou93 (500 in chips)
HumptyD: posts small blind 10
niou93: posts big blind 20
*** HOLE CARDS ***
Dealt to HumptyD [7d 3d]
Weronika93: calls 20
HumptyD: folds
niou93: checks
*** FLOP *** [5h Tc 2d]
niou93: checks
Weronika93: bets 480 and is all-in
niou93: folds
Uncalled bet (480) returned to Weronika93
Weronika93 collected 50 from pot
*** SUMMARY ***
Total pot 50 | Rake 0
Board [5h Tc 2d]
Seat 1: Weronika93 (button) collected (50)
Seat 2: HumptyD (small blind) folded before Flop
Seat 3: niou93 (big blind) folded on the Flop

PokerStars Hand #251180721999: Tournament #3770708484, $0.46+$0.04 USD Hold'em No Limit - Level I (10/20) - 2024/06/24 20:19:24 ET
Table '3770708484 1' 3-max Seat #2 is the button
Seat 1: Weronika93 (530 in chips)
Seat 2: HumptyD (490 in chips)
Seat 3: niou93 (480 in chips)
niou93: posts small blind 10
Weronika93: posts big blind 20
*** HOLE CARDS ***
Dealt to HumptyD [5s 4d]
HumptyD: folds
niou93: calls 10
Weronika93: raises 20 to 40
niou93: calls 20
*** FLOP *** [Kh 8c 4s]
niou93: checks
Weronika93: bets 490 and is all-in
niou93: folds
Uncalled bet (490) returned to Weronika93
Weronika93 collected 80 from pot
*** SUMMARY ***
Total pot 80 | Rake 0
Board [Kh 8c 4s]
Seat 1: Weronika93 (big blind) collected (80)
Seat 2: HumptyD (button) folded before Flop (didn't bet)
Seat 3: niou93 (small blind) folded on the Flop

PokerStars Hand #251180725288: Tournament #3770708484, $0.46+$0.04 USD Hold'em No Limit - Level I (10/20) - 2024/06/24 20:19:43 ET
Table '3770708484 1' 3-max Seat #3 is the button
Seat 1: Weronika93 (570 in chips)
Seat 2: HumptyD (490 in chips)
Seat 3: niou93 (440 in chips)
Weronika93: posts small blind 10
HumptyD: posts big blind 20
*** HOLE CARDS ***
Dealt to HumptyD [2s 5c]
niou93: raises 20 to 40
Weronika93: raises 530 to 570 and is all-in
HumptyD: folds
niou93: calls 400 and is all-in
Uncalled bet (130) returned to Weronika93
*** FLOP *** [6h 9h 3s]
*** TURN *** [6h 9h 3s] [6d]
*** RIVER *** [6h 9h 3s 6d] [Ac]
*** SHOW DOWN ***
Weronika93: shows [4h 4c] (two pair, Sixes and Fours)
niou93: shows [7c 9c] (two pair, Nines and Sixes)
niou93 collected 900 from pot
*** SUMMARY ***
Total pot 900 | Rake 0
Board [6h 9h 3s 6d Ac]
Seat 1: Weronika93 (small blind) showed [4h 4c] and lost with two pair, Sixes and Fours
Seat 2: HumptyD (big blind) folded before Flop
Seat 3: niou93 (button) showed [7c 9c] and won (900) with two pair, Nines and Sixes

PokerStars Hand #251180727939: Tournament #3770708484, $0.46+$0.04 USD Hold'em No Limit - Level I (10/20) - 2024/06/24 20:19:59 ET
Table '3770708484 1' 3-max Seat #1 is the button
Seat 1: Weronika93 (130 in chips)
Seat 2: HumptyD (470 in chips)
Seat 3: niou93 (900 in chips)
HumptyD: posts small blind 10
niou93: posts big blind 20
*** HOLE CARDS ***
Dealt to HumptyD [9h 9d]
Weronika93: raises 110 to 130 and is all-in
HumptyD: raises 340 to 470 and is all-in
niou93: folds
Uncalled bet (340) returned to HumptyD
*** FLOP *** [5h 4h Ad]
*** TURN *** [5h 4h Ad] [9s]
*** RIVER *** [5h 4h Ad 9s] [2c]
*** SHOW DOWN ***
HumptyD: shows [9h 9d] (three of a kind, Nines)
Weronika93: shows [Qd 4d] (a pair of Fours)
HumptyD collected 280 from pot
Weronika93 finished the tournament in 3rd place
*** SUMMARY ***
Total pot 280 | Rake 0
Board [5h 4h Ad 9s 2c]
Seat 1: Weronika93 (button) showed [Qd 4d] and lost with a pair of Fours
Seat 2: HumptyD (small blind) showed [9h 9d] and won (280) with three of a kind, Nines
Seat 3: niou93 (big blind) folded before Flop

PokerStars Hand #251180732773: Tournament #3770708484, $0.46+$0.04 USD Hold'em No Limit - Level I (10/20) - 2024/06/24 20:20:27 ET
Table '3770708484 1' 3-max Seat #3 is the button
Seat 2: HumptyD (620 in chips)
Seat 3: niou93 (880 in chips)
niou93: posts small blind 10
HumptyD: posts big blind 20
*** HOLE CARDS ***
Dealt to HumptyD [7c Kh]
niou93: raises 20 to 40
HumptyD: calls 20
*** FLOP *** [2d 3d 2s]
HumptyD: checks
niou93: bets 40
HumptyD: folds
Uncalled bet (40) returned to niou93
niou93 collected 80 from pot
*** SUMMARY ***
Total pot 80 | Rake 0
Board [2d 3d 2s]
Seat 2: HumptyD (big blind) folded on the Flop
Seat 3: niou93 (button) (small blind) collected (80)

PokerStars Hand #251180736104: Tournament #3770708484, $0.46+$0.04 USD Hold'em No Limit - Level I (10/20) - 2024/06/24 20:20:46 ET
Table '3770708484 1' 3-max Seat #2 is the button
Seat 2: HumptyD (580 in chips)
Seat 3: niou93 (920 in chips)
HumptyD: posts small blind 10
niou93: posts big blind 20
*** HOLE CARDS ***
Dealt to HumptyD [5s Kh]
HumptyD: calls 10
niou93: raises 40 to 60
HumptyD: folds
Uncalled bet (40) returned to niou93
niou93 collected 40 from pot
*** SUMMARY ***
Total pot 40 | Rake 0
Seat 2: HumptyD (button) (small blind) folded before Flop
Seat 3: niou93 (big blind) collected (40)

PokerStars Hand #251180738392: Tournament #3770708484, $0.46+$0.04 USD Hold'em No Limit - Level I (10/20) - 2024/06/24 20:20:59 ET
Table '3770708484 1' 3-max Seat #3 is the button
Seat 2: HumptyD (560 in chips)
Seat 3: niou93 (940 in chips)
niou93: posts small blind 10
HumptyD: posts big blind 20
*** HOLE CARDS ***
Dealt to HumptyD [9d Qc]
niou93: calls 10
HumptyD: checks
*** FLOP *** [4c As 4s]
HumptyD: checks
niou93: checks
*** TURN *** [4c As 4s] [2c]
HumptyD: checks
niou93: checks
*** RIVER *** [4c As 4s 2c] [Td]
HumptyD: checks
niou93: bets 20
HumptyD: folds
Uncalled bet (20) returned to niou93
niou93 collected 40 from pot
*** SUMMARY ***
Total pot 40 | Rake 0
Board [4c As 4s 2c Td]
Seat 2: HumptyD (big blind) folded on the River
Seat 3: niou93 (button) (small blind) collected (40)

PokerStars Hand #251180743272: Tournament #3770708484, $0.46+$0.04 USD Hold'em No Limit - Level II (15/30) - 2024/06/24 20:21:26 ET
Table '3770708484 1' 3-max Seat #2 is the button
Seat 2: HumptyD (540 in chips)
Seat 3: niou93 (960 in chips)
HumptyD: posts small blind 15
niou93: posts big blind 30
*** HOLE CARDS ***
Dealt to HumptyD [9s As]
HumptyD: calls 15
niou93: raises 30 to 60
HumptyD: raises 480 to 540 and is all-in
niou93: calls 480
*** FLOP *** [Jh Qc Td]
*** TURN *** [Jh Qc Td] [3h]
*** RIVER *** [Jh Qc Td 3h] [4d]
*** SHOW DOWN ***
niou93: shows [Qs Th] (two pair, Queens and Tens)
HumptyD: shows [9s As] (high card Ace)
niou93 collected 1080 from pot
HumptyD finished the tournament in 2nd place
niou93 wins the tournament - congratulations!
niou93 wins a '$1.00 Power Path Step 2 Ticket' ticket
*** SUMMARY ***
Total pot 1080 | Rake 0
Board [Jh Qc Td 3h 4d]
Seat 2: HumptyD (button) (small blind) showed [9s As] and lost with high card Ace
Seat 3: niou93 (big blind) showed [Qs Th] and won (1080) with two pair, Queens and Tens


Hand ID: 11

PokerStars Zoom Hand #251193325725:  Hold'em No Limit ($0.01/$0.02) - 2024/06/25 17:34:54 ET
Table 'Halley' 6-max Seat #1 is the button
Seat 1: mr.Lugaro ($2.48 in chips)
Seat 2: Gaigel ($2 in chips)
Seat 3: HumptyD ($2 in chips)
Seat 4: maxteo15 ($5.89 in chips)
Seat 5: Joey_PS2 ($2.73 in chips)
Seat 6: Malzuk ($4.19 in chips)
Gaigel: posts small blind $0.01
HumptyD: posts big blind $0.02
*** HOLE CARDS ***
Dealt to HumptyD [7h Jd]
maxteo15: raises $0.03 to $0.05
Joey_PS2: folds
Malzuk: folds
mr.Lugaro: folds
Gaigel: folds
HumptyD: folds
Uncalled bet ($0.03) returned to maxteo15
maxteo15 collected $0.05 from pot
maxteo15: doesn't show hand
*** SUMMARY ***
Total pot $0.05 | Rake $0
Seat 1: mr.Lugaro (button) folded before Flop (didn't bet)
Seat 2: Gaigel (small blind) folded before Flop
Seat 3: HumptyD (big blind) folded before Flop
Seat 4: maxteo15 collected ($0.05)
Seat 5: Joey_PS2 folded before Flop (didn't bet)
Seat 6: Malzuk folded before Flop (didn't bet)

PokerStars Zoom Hand #251193328367:  Hold'em No Limit ($0.01/$0.02) - 2024/06/25 17:35:03 ET
Table 'Halley' 6-max Seat #1 is the button
Seat 1: DONITA60 ($4.21 in chips)
Seat 2: HumptyD ($2 in chips)
Seat 3: bizbakol ($1.67 in chips)
Seat 4: Malzuk ($4.18 in chips)
Seat 5: Nomi Kopi ($3.44 in chips)
Seat 6: tom P69 ($1.71 in chips)
HumptyD: posts small blind $0.01
bizbakol: posts big blind $0.02
*** HOLE CARDS ***
Dealt to HumptyD [Td 4s]
Malzuk: folds
Nomi Kopi: raises $0.04 to $0.06
tom P69: folds
DONITA60: folds
HumptyD: folds
bizbakol: folds
Uncalled bet ($0.04) returned to Nomi Kopi
Nomi Kopi collected $0.05 from pot
Nomi Kopi: doesn't show hand
*** SUMMARY ***
Total pot $0.05 | Rake $0
Seat 1: DONITA60 (button) folded before Flop (didn't bet)
Seat 2: HumptyD (small blind) folded before Flop
Seat 3: bizbakol (big blind) folded before Flop
Seat 4: Malzuk folded before Flop (didn't bet)
Seat 5: Nomi Kopi collected ($0.05)
Seat 6: tom P69 folded before Flop (didn't bet)

PokerStars Zoom Hand #251193337221:  Hold'em No Limit ($0.01/$0.02) - 2024/06/25 17:35:34 ET
Table 'Halley' 6-max Seat #1 is the button
Seat 1: HumptyD ($2 in chips)
Seat 2: siwyCFC ($2.09 in chips)
Seat 3: Malzuk ($4.18 in chips)
Seat 4: JahromeT ($5.20 in chips)
Seat 5: Gattini37 ($2.46 in chips)
Seat 6: TSCardinals ($2 in chips)
siwyCFC: posts small blind $0.01
Malzuk: posts big blind $0.02
*** HOLE CARDS ***
Dealt to HumptyD [6h 8s]
JahromeT: raises $0.04 to $0.06
Gattini37: folds
TSCardinals: folds
HumptyD: folds
siwyCFC: folds
Malzuk: folds
Uncalled bet ($0.04) returned to JahromeT
JahromeT collected $0.05 from pot
JahromeT: doesn't show hand
*** SUMMARY ***
Total pot $0.05 | Rake $0
Seat 1: HumptyD (button) folded before Flop (didn't bet)
Seat 2: siwyCFC (small blind) folded before Flop
Seat 3: Malzuk (big blind) folded before Flop
Seat 4: JahromeT collected ($0.05)
Seat 5: Gattini37 folded before Flop (didn't bet)
Seat 6: TSCardinals folded before Flop (didn't bet)

PokerStars Zoom Hand #251193339756:  Hold'em No Limit ($0.01/$0.02) - 2024/06/25 17:35:43 ET
Table 'Halley' 6-max Seat #1 is the button
Seat 1: arlek1n22 ($2.19 in chips)
Seat 2: Oto_Sebas ($2.09 in chips)
Seat 3: gasmar_29 ($2.32 in chips)
Seat 4: GPhil21 ($4.33 in chips)
Seat 5: HumptyD ($2 in chips)
Seat 6: maxteo15 ($2.24 in chips)
Oto_Sebas: posts small blind $0.01
gasmar_29: posts big blind $0.02
*** HOLE CARDS ***
Dealt to HumptyD [5s Jh]
GPhil21: folds
HumptyD: folds
maxteo15: folds
arlek1n22: folds
Oto_Sebas: folds
Uncalled bet ($0.01) returned to gasmar_29
gasmar_29 collected $0.02 from pot
gasmar_29: doesn't show hand
*** SUMMARY ***
Total pot $0.02 | Rake $0
Seat 1: arlek1n22 (button) folded before Flop (didn't bet)
Seat 2: Oto_Sebas (small blind) folded before Flop
Seat 3: gasmar_29 (big blind) collected ($0.02)
Seat 4: GPhil21 folded before Flop (didn't bet)
Seat 5: HumptyD folded before Flop (didn't bet)
Seat 6: maxteo15 folded before Flop (didn't bet)

PokerStars Zoom Hand #251193341493:  Hold'em No Limit ($0.01/$0.02) - 2024/06/25 17:35:49 ET
Table 'Halley' 6-max Seat #1 is the button
Seat 1: Losimas(LT) ($2.75 in chips)
Seat 2: ACA 2009 A ($1.27 in chips)
Seat 3: IndyVegas67 ($9.44 in chips)
Seat 4: honda1947 ($6.40 in chips)
Seat 5: Malzuk ($4.16 in chips)
Seat 6: HumptyD ($2 in chips)
ACA 2009 A: posts small blind $0.01
IndyVegas67: posts big blind $0.02
*** HOLE CARDS ***
Dealt to HumptyD [2d Qc]
honda1947: folds
Malzuk: folds
HumptyD: folds
Losimas(LT): folds
ACA 2009 A: folds
Uncalled bet ($0.01) returned to IndyVegas67
IndyVegas67 collected $0.02 from pot
IndyVegas67: doesn't show hand
*** SUMMARY ***
Total pot $0.02 | Rake $0
Seat 1: Losimas(LT) (button) folded before Flop (didn't bet)
Seat 2: ACA 2009 A (small blind) folded before Flop
Seat 3: IndyVegas67 (big blind) collected ($0.02)
Seat 4: honda1947 folded before Flop (didn't bet)
Seat 5: Malzuk folded before Flop (didn't bet)
Seat 6: HumptyD folded before Flop (didn't bet)

PokerStars Zoom Hand #251193342908:  Hold'em No Limit ($0.01/$0.02) - 2024/06/25 17:35:54 ET
Table 'Halley' 6-max Seat #1 is the button
Seat 1: maxteo15 ($2.24 in chips)
Seat 2: Elwin Sariel ($2.03 in chips)
Seat 3: HumptyD ($2 in chips)
Seat 4: Fox00777 ($2.98 in chips)
Seat 5: mr.Lugaro ($3.81 in chips)
Seat 6: TSCardinals ($2.71 in chips)
Elwin Sariel: posts small blind $0.01
HumptyD: posts big blind $0.02
*** HOLE CARDS ***
Dealt to HumptyD [6h 6d]
Fox00777: folds
mr.Lugaro: folds
TSCardinals: raises $0.04 to $0.06
maxteo15: folds
Elwin Sariel: folds
HumptyD: calls $0.04
*** FLOP *** [7d 9h Th]
HumptyD: checks
TSCardinals: bets $0.10
HumptyD: folds
Uncalled bet ($0.10) returned to TSCardinals
TSCardinals collected $0.13 from pot
TSCardinals: doesn't show hand
*** SUMMARY ***
Total pot $0.13 | Rake $0
Board [7d 9h Th]
Seat 1: maxteo15 (button) folded before Flop (didn't bet)
Seat 2: Elwin Sariel (small blind) folded before Flop
Seat 3: HumptyD (big blind) folded on the Flop
Seat 4: Fox00777 folded before Flop (didn't bet)
Seat 5: mr.Lugaro folded before Flop (didn't bet)
Seat 6: TSCardinals collected ($0.13)

PokerStars Zoom Hand #251193361039:  Hold'em No Limit ($0.01/$0.02) - 2024/06/25 17:36:58 ET
Table 'Halley' 6-max Seat #1 is the button
Seat 1: Roosvelt67 ($1.04 in chips)
Seat 2: HumptyD ($2 in chips)
Seat 3: luisao179 ($1 in chips)
Seat 4: AT1LL4ZOREdd ($7.57 in chips)
Seat 5: DONITA60 ($2.38 in chips)
Seat 6: Mopsi995 ($2.08 in chips)
HumptyD: posts small blind $0.01
luisao179: posts big blind $0.02
*** HOLE CARDS ***
Dealt to HumptyD [6h Qh]
AT1LL4ZOREdd: folds
DONITA60: folds
Mopsi995: folds
Roosvelt67: folds
HumptyD: raises $0.04 to $0.06
luisao179: folds
Uncalled bet ($0.04) returned to HumptyD
HumptyD collected $0.04 from pot
HumptyD: doesn't show hand
*** SUMMARY ***
Total pot $0.04 | Rake $0
Seat 1: Roosvelt67 (button) folded before Flop (didn't bet)
Seat 2: HumptyD (small blind) collected ($0.04)
Seat 3: luisao179 (big blind) folded before Flop
Seat 4: AT1LL4ZOREdd folded before Flop (didn't bet)
Seat 5: DONITA60 folded before Flop (didn't bet)
Seat 6: Mopsi995 folded before Flop (didn't bet)

PokerStars Zoom Hand #251193358725:  Hold'em No Limit ($0.01/$0.02) - 2024/06/25 17:36:50 ET
Table 'Halley' 6-max Seat #1 is the button
Seat 1: djulio94rike ($4.88 in chips)
Seat 2: GoldeN0330 ($2 in chips)
Seat 3: IndyVegas67 ($9.47 in chips)
Seat 4: HumptyD ($2 in chips)
Seat 5: Losimas(LT) ($2 in chips)
Seat 6: gomusin ($2.76 in chips)
GoldeN0330: posts small blind $0.01
IndyVegas67: posts big blind $0.02
*** HOLE CARDS ***
Dealt to HumptyD [Ac 3h]
HumptyD: folds
Losimas(LT): raises $0.03 to $0.05
gomusin: folds
djulio94rike: folds
GoldeN0330: folds
IndyVegas67: calls $0.03
*** FLOP *** [6c 2d 9c]
IndyVegas67: checks
Losimas(LT): checks
*** TURN *** [6c 2d 9c] [7h]
IndyVegas67: checks
Losimas(LT): checks
*** RIVER *** [6c 2d 9c 7h] [3s]
IndyVegas67: bets $0.02
Losimas(LT): folds
Uncalled bet ($0.02) returned to IndyVegas67
IndyVegas67 collected $0.11 from pot
IndyVegas67: doesn't show hand
*** SUMMARY ***
Total pot $0.11 | Rake $0
Board [6c 2d 9c 7h 3s]
Seat 1: djulio94rike (button) folded before Flop (didn't bet)
Seat 2: GoldeN0330 (small blind) folded before Flop
Seat 3: IndyVegas67 (big blind) collected ($0.11)
Seat 4: HumptyD folded before Flop (didn't bet)
Seat 5: Losimas(LT) folded on the River
Seat 6: gomusin folded before Flop (didn't bet)

PokerStars Zoom Hand #251193366355:  Hold'em No Limit ($0.01/$0.02) - 2024/06/25 17:37:17 ET
Table 'Halley' 6-max Seat #1 is the button
Seat 1: HumptyD ($2.02 in chips)
Seat 2: Gonzaov ($0.85 in chips)
Seat 3: Merchtens ($1.68 in chips)
Seat 4: LavrikSanta ($2 in chips)
Seat 5: JORDYLEON ($13.04 in chips)
Seat 6: JahromeT ($5.20 in chips)
Gonzaov: posts small blind $0.01
Merchtens: posts big blind $0.02
*** HOLE CARDS ***
Dealt to HumptyD [Ah 9d]
LavrikSanta: folds
JORDYLEON: raises $0.03 to $0.05
JahromeT: folds
HumptyD: raises $0.13 to $0.18
Gonzaov: folds
Merchtens: folds
JORDYLEON: folds
Uncalled bet ($0.13) returned to HumptyD
HumptyD collected $0.13 from pot
HumptyD: doesn't show hand
*** SUMMARY ***
Total pot $0.13 | Rake $0
Seat 1: HumptyD (button) collected ($0.13)
Seat 2: Gonzaov (small blind) folded before Flop
Seat 3: Merchtens (big blind) folded before Flop
Seat 4: LavrikSanta folded before Flop (didn't bet)
Seat 5: JORDYLEON folded before Flop
Seat 6: JahromeT folded before Flop (didn't bet)

PokerStars Zoom Hand #251193373206:  Hold'em No Limit ($0.01/$0.02) - 2024/06/25 17:37:41 ET
Table 'Halley' 6-max Seat #1 is the button
Seat 1: SagazZ ($1.11 in chips)
Seat 2: mistershahuk ($4.47 in chips)
Seat 3: Thebuntu ($2.69 in chips)
Seat 4: HumptyD ($2.10 in chips)
Seat 5: brenopmo ($2.28 in chips)
Seat 6: tom P69 ($1.70 in chips)
mistershahuk: posts small blind $0.01
Thebuntu: posts big blind $0.02
*** HOLE CARDS ***
Dealt to HumptyD [Ac Kc]
HumptyD: raises $0.04 to $0.06
brenopmo: folds
tom P69: folds
SagazZ: raises $0.04 to $0.10
mistershahuk: folds
Thebuntu: calls $0.08
HumptyD: raises $0.31 to $0.41
SagazZ: folds
Thebuntu: raises $1.86 to $2.27
HumptyD: calls $1.69 and is all-in
Uncalled bet ($0.17) returned to Thebuntu
*** FLOP *** [8d Th As]
*** TURN *** [8d Th As] [3s]
*** RIVER *** [8d Th As 3s] [2c]
*** SHOW DOWN ***
Thebuntu: shows [8c 8s] (three of a kind, Eights)
HumptyD: shows [Ac Kc] (a pair of Aces)
Thebuntu collected $4.16 from pot
*** SUMMARY ***
Total pot $4.31 | Rake $0.15
Board [8d Th As 3s 2c]
Seat 1: SagazZ (button) folded before Flop
Seat 2: mistershahuk (small blind) folded before Flop
Seat 3: Thebuntu (big blind) showed [8c 8s] and won ($4.16) with three of a kind, Eights
Seat 4: HumptyD showed [Ac Kc] and lost with a pair of Aces
Seat 5: brenopmo folded before Flop (didn't bet)
Seat 6: tom P69 folded before Flop (didn't bet)

PokerStars Zoom Hand #251193387981:  Hold'em No Limit ($0.01/$0.02) - 2024/06/25 17:38:33 ET
Table 'Halley' 6-max Seat #1 is the button
Seat 1: Haryel Hernande ($4.73 in chips)
Seat 2: Gattini37 ($2.66 in chips)
Seat 3: coolDadJimbo ($3.02 in chips)
Seat 4: Fox00777 ($5.35 in chips)
Seat 5: cod4x ($2.29 in chips)
Seat 6: HumptyD ($2 in chips)
Gattini37: posts small blind $0.01
coolDadJimbo: posts big blind $0.02
*** HOLE CARDS ***
Dealt to HumptyD [7s Kd]
Fox00777: folds
cod4x: raises $0.02 to $0.04
HumptyD: folds
Haryel Hernande: folds
Gattini37: folds
coolDadJimbo: folds
Uncalled bet ($0.02) returned to cod4x
cod4x collected $0.05 from pot
cod4x: doesn't show hand
*** SUMMARY ***
Total pot $0.05 | Rake $0
Seat 1: Haryel Hernande (button) folded before Flop (didn't bet)
Seat 2: Gattini37 (small blind) folded before Flop
Seat 3: coolDadJimbo (big blind) folded before Flop
Seat 4: Fox00777 folded before Flop (didn't bet)
Seat 5: cod4x collected ($0.05)
Seat 6: HumptyD folded before Flop (didn't bet)

PokerStars Zoom Hand #251193389092:  Hold'em No Limit ($0.01/$0.02) - 2024/06/25 17:38:37 ET
Table 'Halley' 6-max Seat #1 is the button
Seat 1: GoldeN0330 ($2.32 in chips)
Seat 2: mr.Lugaro ($2.84 in chips)
Seat 3: GUILLE 1308 ($0.35 in chips)
Seat 4: MauDilly ($1.27 in chips)
Seat 5: JFray756 ($2.03 in chips)
Seat 6: HumptyD ($2 in chips)
mr.Lugaro: posts small blind $0.01
GUILLE 1308: posts big blind $0.02
*** HOLE CARDS ***
Dealt to HumptyD [Kd Js]
MauDilly: raises $0.02 to $0.04
JFray756: folds
HumptyD: folds
GoldeN0330: folds
mr.Lugaro: folds
GUILLE 1308: calls $0.02
*** FLOP *** [Ks 4h 2h]
GUILLE 1308: checks
MauDilly: checks
*** TURN *** [Ks 4h 2h] [3d]
GUILLE 1308: checks
MauDilly: checks
*** RIVER *** [Ks 4h 2h 3d] [9d]
GUILLE 1308: checks
MauDilly: checks
*** SHOW DOWN ***
GUILLE 1308: shows [Ac 2s] (a pair of Deuces)
MauDilly: mucks hand
GUILLE 1308 collected $0.09 from pot
*** SUMMARY ***
Total pot $0.09 | Rake $0
Board [Ks 4h 2h 3d 9d]
Seat 1: GoldeN0330 (button) folded before Flop (didn't bet)
Seat 2: mr.Lugaro (small blind) folded before Flop
Seat 3: GUILLE 1308 (big blind) showed [Ac 2s] and won ($0.09) with a pair of Deuces
Seat 4: MauDilly mucked [Ah Jc]
Seat 5: JFray756 folded before Flop (didn't bet)
Seat 6: HumptyD folded before Flop (didn't bet)

PokerStars Zoom Hand #251193395934:  Hold'em No Limit ($0.01/$0.02) - 2024/06/25 17:39:01 ET
Table 'Halley' 6-max Seat #1 is the button
Seat 1: bel_2302 ($2.51 in chips)
Seat 2: mianduar280216 ($3.37 in chips)
Seat 3: HumptyD ($2 in chips)
Seat 4: Reillyo123 ($3.36 in chips)
Seat 5: cod4x ($2.61 in chips)
Seat 6: DonRazVan18 ($2.40 in chips)
mianduar280216: posts small blind $0.01
HumptyD: posts big blind $0.02
*** HOLE CARDS ***
Dealt to HumptyD [As 7d]
Reillyo123: folds
cod4x: raises $0.02 to $0.04
DonRazVan18: folds
bel_2302: folds
mianduar280216: folds
HumptyD: calls $0.02
*** FLOP *** [Ks 5s 4h]
HumptyD: checks
cod4x: bets $0.09
HumptyD: folds
Uncalled bet ($0.09) returned to cod4x
cod4x collected $0.09 from pot
cod4x: doesn't show hand
*** SUMMARY ***
Total pot $0.09 | Rake $0
Board [Ks 5s 4h]
Seat 1: bel_2302 (button) folded before Flop (didn't bet)
Seat 2: mianduar280216 (small blind) folded before Flop
Seat 3: HumptyD (big blind) folded on the Flop
Seat 4: Reillyo123 folded before Flop (didn't bet)
Seat 5: cod4x collected ($0.09)
Seat 6: DonRazVan18 folded before Flop (didn't bet)

PokerStars Zoom Hand #251193404012:  Hold'em No Limit ($0.01/$0.02) - 2024/06/25 17:39:29 ET
Table 'Halley' 6-max Seat #1 is the button
Seat 1: Nomi Kopi ($1.32 in chips)
Seat 2: HumptyD ($2 in chips)
Seat 3: Karfmad ($2.06 in chips)
Seat 4: Money4meBr ($1.51 in chips)
Seat 5: Emag fo Dog ($3.88 in chips)
Seat 6: Agusy666 ($6.53 in chips)
HumptyD: posts small blind $0.01
Karfmad: posts big blind $0.02
*** HOLE CARDS ***
Dealt to HumptyD [Kh 4d]
Money4meBr: folds
Emag fo Dog: raises $0.04 to $0.06
Agusy666: folds
Nomi Kopi: folds
HumptyD: folds
Karfmad: folds
Uncalled bet ($0.04) returned to Emag fo Dog
Emag fo Dog collected $0.05 from pot
Emag fo Dog: doesn't show hand
*** SUMMARY ***
Total pot $0.05 | Rake $0
Seat 1: Nomi Kopi (button) folded before Flop (didn't bet)
Seat 2: HumptyD (small blind) folded before Flop
Seat 3: Karfmad (big blind) folded before Flop
Seat 4: Money4meBr folded before Flop (didn't bet)
Seat 5: Emag fo Dog collected ($0.05)
Seat 6: Agusy666 folded before Flop (didn't bet)

PokerStars Zoom Hand #251193410196:  Hold'em No Limit ($0.01/$0.02) - 2024/06/25 17:39:51 ET
Table 'Halley' 6-max Seat #1 is the button
Seat 1: Elwin Sariel ($2 in chips)
Seat 2: Karfmad ($2.04 in chips)
Seat 3: WolfTag ($1.98 in chips)
Seat 4: ontt22 ($5.31 in chips)
Seat 5: HumptyD ($2 in chips)
Seat 6: mr.Lugaro ($3.32 in chips)
Karfmad: posts small blind $0.01
WolfTag: posts big blind $0.02
*** HOLE CARDS ***
Dealt to HumptyD [Td 3h]
ontt22: folds
HumptyD: folds
mr.Lugaro: folds
Elwin Sariel: folds
Karfmad: folds
Uncalled bet ($0.01) returned to WolfTag
WolfTag collected $0.02 from pot
WolfTag: doesn't show hand
*** SUMMARY ***
Total pot $0.02 | Rake $0
Seat 1: Elwin Sariel (button) folded before Flop (didn't bet)
Seat 2: Karfmad (small blind) folded before Flop
Seat 3: WolfTag (big blind) collected ($0.02)
Seat 4: ontt22 folded before Flop (didn't bet)
Seat 5: HumptyD folded before Flop (didn't bet)
Seat 6: mr.Lugaro folded before Flop (didn't bet)

PokerStars Zoom Hand #251193407101:  Hold'em No Limit ($0.01/$0.02) - 2024/06/25 17:39:40 ET
Table 'Halley' 6-max Seat #1 is the button
Seat 1: inthegreenz369 ($3.30 in chips)
Seat 2: Mopsi995 ($2.08 in chips)
Seat 3: iFRODOi ($2.81 in chips)
Seat 4: sidrauski25 ($1.04 in chips)
Seat 5: HumptyD ($2 in chips)
Seat 6: djulio94rike ($4.77 in chips)
Mopsi995: posts small blind $0.01
iFRODOi: posts big blind $0.02
*** HOLE CARDS ***
Dealt to HumptyD [Qc 4s]
sidrauski25: folds
HumptyD: folds
djulio94rike: folds
inthegreenz369: folds
Mopsi995: raises $0.04 to $0.06
iFRODOi: folds
Uncalled bet ($0.04) returned to Mopsi995
Mopsi995 collected $0.04 from pot
Mopsi995: doesn't show hand
*** SUMMARY ***
Total pot $0.04 | Rake $0
Seat 1: inthegreenz369 (button) folded before Flop (didn't bet)
Seat 2: Mopsi995 (small blind) collected ($0.04)
Seat 3: iFRODOi (big blind) folded before Flop
Seat 4: sidrauski25 folded before Flop (didn't bet)
Seat 5: HumptyD folded before Flop (didn't bet)
Seat 6: djulio94rike folded before Flop (didn't bet)

PokerStars Zoom Hand #251193409054:  Hold'em No Limit ($0.01/$0.02) - 2024/06/25 17:39:47 ET
Table 'Halley' 6-max Seat #1 is the button
Seat 1: HumptyD ($2 in chips)
Seat 2: Losimas(LT) ($2 in chips)
Seat 3: Master Jekku ($2 in chips)
Seat 4: ranjete330 ($1.82 in chips)
Seat 5: JahromeT ($4.98 in chips)
Seat 6: niderlander ($4.61 in chips)
Losimas(LT): posts small blind $0.01
Master Jekku: posts big blind $0.02
*** HOLE CARDS ***
Dealt to HumptyD [6h Js]
ranjete330: raises $0.02 to $0.04
JahromeT: folds
niderlander: folds
HumptyD: folds
Losimas(LT): folds
Master Jekku: folds
Uncalled bet ($0.02) returned to ranjete330
ranjete330 collected $0.05 from pot
ranjete330: doesn't show hand
*** SUMMARY ***
Total pot $0.05 | Rake $0
Seat 1: HumptyD (button) folded before Flop (didn't bet)
Seat 2: Losimas(LT) (small blind) folded before Flop
Seat 3: Master Jekku (big blind) folded before Flop
Seat 4: ranjete330 collected ($0.05)
Seat 5: JahromeT folded before Flop (didn't bet)
Seat 6: niderlander folded before Flop (didn't bet)

PokerStars Zoom Hand #251193411827:  Hold'em No Limit ($0.01/$0.02) - 2024/06/25 17:39:57 ET
Table 'Halley' 6-max Seat #1 is the button
Seat 1: JJcastk2 ($3.94 in chips)
Seat 2: marcelobr88888 ($2.06 in chips)
Seat 3: mr.Lugaro ($3.32 in chips)
Seat 4: fechagas15 ($2.04 in chips)
Seat 5: arlek1n22 ($1.38 in chips)
Seat 6: HumptyD ($2 in chips)
marcelobr88888: posts small blind $0.01
mr.Lugaro: posts big blind $0.02
*** HOLE CARDS ***
Dealt to HumptyD [Qd 8h]
fechagas15 is disconnected
fechagas15 has timed out while disconnected
fechagas15: folds
arlek1n22: folds
HumptyD: folds
JJcastk2: folds
marcelobr88888: folds
Uncalled bet ($0.01) returned to mr.Lugaro
mr.Lugaro collected $0.02 from pot
mr.Lugaro: doesn't show hand
*** SUMMARY ***
Total pot $0.02 | Rake $0
Seat 1: JJcastk2 (button) folded before Flop (didn't bet)
Seat 2: marcelobr88888 (small blind) folded before Flop
Seat 3: mr.Lugaro (big blind) collected ($0.02)
Seat 4: fechagas15 folded before Flop (didn't bet)
Seat 5: arlek1n22 folded before Flop (didn't bet)
Seat 6: HumptyD folded before Flop (didn't bet)

PokerStars Zoom Hand #251193412990:  Hold'em No Limit ($0.01/$0.02) - 2024/06/25 17:40:01 ET
Table 'Halley' 6-max Seat #1 is the button
Seat 1: Malzuk ($3.46 in chips)
Seat 2: ontt22 ($5.31 in chips)
Seat 3: HumptyD ($2 in chips)
Seat 4: Haryel Hernande ($4.26 in chips)
Seat 5: coolDadJimbo ($3.19 in chips)
Seat 6: JORDYLEON ($4.01 in chips)
ontt22: posts small blind $0.01
HumptyD: posts big blind $0.02
*** HOLE CARDS ***
Dealt to HumptyD [7h 2h]
Haryel Hernande: folds
coolDadJimbo: folds
JORDYLEON: raises $0.03 to $0.05
Malzuk: folds
ontt22: folds
HumptyD: folds
Uncalled bet ($0.03) returned to JORDYLEON
JORDYLEON collected $0.05 from pot
JORDYLEON: doesn't show hand
*** SUMMARY ***
Total pot $0.05 | Rake $0
Seat 1: Malzuk (button) folded before Flop (didn't bet)
Seat 2: ontt22 (small blind) folded before Flop
Seat 3: HumptyD (big blind) folded before Flop
Seat 4: Haryel Hernande folded before Flop (didn't bet)
Seat 5: coolDadJimbo folded before Flop (didn't bet)
Seat 6: JORDYLEON collected ($0.05)

PokerStars Zoom Hand #251193420209:  Hold'em No Limit ($0.01/$0.02) - 2024/06/25 17:40:27 ET
Table 'Halley' 6-max Seat #1 is the button
Seat 1: Cowden Calling ($1.99 in chips)
Seat 2: honda1947 ($6.17 in chips)
Seat 3: flqcommander ($2 in chips)
Seat 4: HumptyD ($2 in chips)
Seat 5: Joey_PS2 ($2.03 in chips)
Seat 6: paha1095 ($0.73 in chips)
honda1947: posts small blind $0.01
flqcommander: posts big blind $0.02
*** HOLE CARDS ***
Dealt to HumptyD [Qh Js]
HumptyD: raises $0.04 to $0.06
Joey_PS2: folds
paha1095: folds
Cowden Calling: folds
honda1947: calls $0.05
flqcommander: folds
*** FLOP *** [Qd 8c Ts]
honda1947: bets $0.14
HumptyD: calls $0.14
*** TURN *** [Qd 8c Ts] [Ac]
honda1947: bets $0.41
HumptyD: calls $0.41
*** RIVER *** [Qd 8c Ts Ac] [7s]
honda1947: bets $0.60
HumptyD: calls $0.60
*** SHOW DOWN ***
honda1947: shows [Tc 8s] (two pair, Tens and Eights)
HumptyD: mucks hand
honda1947 collected $2.35 from pot
*** SUMMARY ***
Total pot $2.44 | Rake $0.09
Board [Qd 8c Ts Ac 7s]
Seat 1: Cowden Calling (button) folded before Flop (didn't bet)
Seat 2: honda1947 (small blind) showed [Tc 8s] and won ($2.35) with two pair, Tens and Eights
Seat 3: flqcommander (big blind) folded before Flop
Seat 4: HumptyD mucked [Qh Js]
Seat 5: Joey_PS2 folded before Flop (didn't bet)
Seat 6: paha1095 folded before Flop (didn't bet)

PokerStars Zoom Hand #251193445122:  Hold'em No Limit ($0.01/$0.02) - 2024/06/25 17:41:55 ET
Table 'Halley' 6-max Seat #1 is the button
Seat 1: JFray756 ($2.43 in chips)
Seat 2: HumptyD ($2 in chips)
Seat 3: LavrikSanta ($2 in chips)
Seat 4: Ryphor ($2.04 in chips)
Seat 5: Nomi Kopi ($2.46 in chips)
Seat 6: cafferata3 ($2.87 in chips)
HumptyD: posts small blind $0.01
LavrikSanta: posts big blind $0.02
*** HOLE CARDS ***
Dealt to HumptyD [3c Jh]
Ryphor: folds
Nomi Kopi: folds
cafferata3: folds
JFray756: folds
HumptyD: folds
Uncalled bet ($0.01) returned to LavrikSanta
LavrikSanta collected $0.02 from pot
LavrikSanta: doesn't show hand
*** SUMMARY ***
Total pot $0.02 | Rake $0
Seat 1: JFray756 (button) folded before Flop (didn't bet)
Seat 2: HumptyD (small blind) folded before Flop
Seat 3: LavrikSanta (big blind) collected ($0.02)
Seat 4: Ryphor folded before Flop (didn't bet)
Seat 5: Nomi Kopi folded before Flop (didn't bet)
Seat 6: cafferata3 folded before Flop (didn't bet)

PokerStars Zoom Hand #251193443700:  Hold'em No Limit ($0.01/$0.02) - 2024/06/25 17:41:50 ET
Table 'Halley' 6-max Seat #1 is the button
Seat 1: gasmar_29 ($2 in chips)
Seat 2: arlek1n22 ($3.01 in chips)
Seat 3: mianduar280216 ($3.33 in chips)
Seat 4: Fox00777 ($3.02 in chips)
Seat 5: HumptyD ($2 in chips)
Seat 6: shabalala1 ($1 in chips)
arlek1n22: posts small blind $0.01
mianduar280216: posts big blind $0.02
*** HOLE CARDS ***
Dealt to HumptyD [5d Ah]
Fox00777: folds
HumptyD: folds
shabalala1: folds
gasmar_29: folds
arlek1n22: folds
Uncalled bet ($0.01) returned to mianduar280216
mianduar280216 collected $0.02 from pot
mianduar280216: doesn't show hand
*** SUMMARY ***
Total pot $0.02 | Rake $0
Seat 1: gasmar_29 (button) folded before Flop (didn't bet)
Seat 2: arlek1n22 (small blind) folded before Flop
Seat 3: mianduar280216 (big blind) collected ($0.02)
Seat 4: Fox00777 folded before Flop (didn't bet)
Seat 5: HumptyD folded before Flop (didn't bet)
Seat 6: shabalala1 folded before Flop (didn't bet)

PokerStars Zoom Hand #251193455288:  Hold'em No Limit ($0.01/$0.02) - 2024/06/25 17:42:31 ET
Table 'Halley' 6-max Seat #1 is the button
Seat 1: HumptyD ($2 in chips)
Seat 2: mr.Lugaro ($3.49 in chips)
Seat 3: AT1LL4ZOREdd ($7.44 in chips)
Seat 4: ontt22 ($5.62 in chips)
Seat 5: priidikas1 ($3.41 in chips)
Seat 6: gamw_TROIKA ($6 in chips)
mr.Lugaro: posts small blind $0.01
AT1LL4ZOREdd: posts big blind $0.02
*** HOLE CARDS ***
Dealt to HumptyD [2s 5h]
ontt22: folds
priidikas1: folds
gamw_TROIKA: folds
HumptyD: folds
mr.Lugaro: folds
Uncalled bet ($0.01) returned to AT1LL4ZOREdd
AT1LL4ZOREdd collected $0.02 from pot
AT1LL4ZOREdd: doesn't show hand
*** SUMMARY ***
Total pot $0.02 | Rake $0
Seat 1: HumptyD (button) folded before Flop (didn't bet)
Seat 2: mr.Lugaro (small blind) folded before Flop
Seat 3: AT1LL4ZOREdd (big blind) collected ($0.02)
Seat 4: ontt22 folded before Flop (didn't bet)
Seat 5: priidikas1 folded before Flop (didn't bet)
Seat 6: gamw_TROIKA folded before Flop (didn't bet)

PokerStars Zoom Hand #251193447848:  Hold'em No Limit ($0.01/$0.02) - 2024/06/25 17:42:05 ET
Table 'Halley' 6-max Seat #1 is the button
Seat 1: g0ndarel91 ($1.13 in chips)
Seat 2: Fox00777 ($5.07 in chips)
Seat 3: Dizais27 ($2.53 in chips)
Seat 4: HumptyD ($2 in chips)
Seat 5: niderlander ($4.49 in chips)
Seat 6: Ryphor ($2.13 in chips)
Fox00777: posts small blind $0.01
Dizais27: posts big blind $0.02
*** HOLE CARDS ***
Dealt to HumptyD [As 4d]
HumptyD: raises $0.04 to $0.06
niderlander: folds
Ryphor: calls $0.06
g0ndarel91: calls $0.06
Fox00777: folds
Dizais27: calls $0.04
*** FLOP *** [8h Kd 2c]
Dizais27: bets $0.04
HumptyD: folds
Ryphor: folds
g0ndarel91: calls $0.04
*** TURN *** [8h Kd 2c] [3d]
Dizais27: bets $0.08
g0ndarel91: folds
Uncalled bet ($0.08) returned to Dizais27
Dizais27 collected $0.32 from pot
Dizais27: doesn't show hand
*** SUMMARY ***
Total pot $0.33 | Rake $0.01
Board [8h Kd 2c 3d]
Seat 1: g0ndarel91 (button) folded on the Turn
Seat 2: Fox00777 (small blind) folded before Flop
Seat 3: Dizais27 (big blind) collected ($0.32)
Seat 4: HumptyD folded on the Flop
Seat 5: niderlander folded before Flop (didn't bet)
Seat 6: Ryphor folded on the Flop

PokerStars Zoom Hand #251193457573:  Hold'em No Limit ($0.01/$0.02) - 2024/06/25 17:42:39 ET
Table 'Halley' 6-max Seat #1 is the button
Seat 1: Fox00777 ($5 in chips)
Seat 2: iFRODOi ($3.74 in chips)
Seat 3: HumptyD ($2 in chips)
Seat 4: Ryphor ($2.07 in chips)
Seat 5: Master Jekku ($2 in chips)
Seat 6: chill.whale ($1.57 in chips)
iFRODOi: posts small blind $0.01
HumptyD: posts big blind $0.02
*** HOLE CARDS ***
Dealt to HumptyD [4s Td]
Ryphor: folds
Master Jekku: folds
chill.whale: folds
Fox00777: folds
iFRODOi: raises $0.04 to $0.06
HumptyD: folds
Uncalled bet ($0.04) returned to iFRODOi
iFRODOi collected $0.04 from pot
iFRODOi: doesn't show hand
*** SUMMARY ***
Total pot $0.04 | Rake $0
Seat 1: Fox00777 (button) folded before Flop (didn't bet)
Seat 2: iFRODOi (small blind) collected ($0.04)
Seat 3: HumptyD (big blind) folded before Flop
Seat 4: Ryphor folded before Flop (didn't bet)
Seat 5: Master Jekku folded before Flop (didn't bet)
Seat 6: chill.whale folded before Flop (didn't bet)

PokerStars Zoom Hand #251193461786:  Hold'em No Limit ($0.01/$0.02) - 2024/06/25 17:42:54 ET
Table 'Halley' 6-max Seat #1 is the button
Seat 1: Karfmad ($2.43 in chips)
Seat 2: MrRooob9899 ($2.17 in chips)
Seat 3: iFRODOi ($3.76 in chips)
Seat 4: DONITA60 ($2.10 in chips)
Seat 5: mr.Lugaro ($3.46 in chips)
Seat 6: HumptyD ($2 in chips)
MrRooob9899: posts small blind $0.01
iFRODOi: posts big blind $0.02
*** HOLE CARDS ***
Dealt to HumptyD [8d 3s]
DONITA60: folds
mr.Lugaro: folds
HumptyD: folds
Karfmad: folds
MrRooob9899: folds
Uncalled bet ($0.01) returned to iFRODOi
iFRODOi collected $0.02 from pot
iFRODOi: doesn't show hand
*** SUMMARY ***
Total pot $0.02 | Rake $0
Seat 1: Karfmad (button) folded before Flop (didn't bet)
Seat 2: MrRooob9899 (small blind) folded before Flop
Seat 3: iFRODOi (big blind) collected ($0.02)
Seat 4: DONITA60 folded before Flop (didn't bet)
Seat 5: mr.Lugaro folded before Flop (didn't bet)
Seat 6: HumptyD folded before Flop (didn't bet)

PokerStars Zoom Hand #251193446472:  Hold'em No Limit ($0.01/$0.02) - 2024/06/25 17:42:00 ET
Table 'Halley' 6-max Seat #1 is the button
Seat 1: HumptyD ($2 in chips)
Seat 2: MrRooob9899 ($1.91 in chips)
Seat 3: iliyan66 ($1.52 in chips)
Seat 4: arlek1n22 ($3 in chips)
Seat 5: cod4x ($2.32 in chips)
Seat 6: hazedanger ($3.55 in chips)
MrRooob9899: posts small blind $0.01
iliyan66: posts big blind $0.02
*** HOLE CARDS ***
Dealt to HumptyD [Kc 4h]
arlek1n22: folds
cod4x: folds
hazedanger: raises $0.04 to $0.06
HumptyD: folds
MrRooob9899: calls $0.05
iliyan66: folds
*** FLOP *** [7d 4s Qh]
MrRooob9899: bets $0.02
hazedanger: raises $0.09 to $0.11
MrRooob9899: calls $0.09
*** TURN *** [7d 4s Qh] [7s]
MrRooob9899: checks
hazedanger: bets $0.21
MrRooob9899: calls $0.21
*** RIVER *** [7d 4s Qh 7s] [2d]
MrRooob9899: bets $0.58
hazedanger: calls $0.58
*** SHOW DOWN ***
MrRooob9899: shows [7c 7h] (four of a kind, Sevens)
hazedanger: mucks hand
MrRooob9899 collected $1.87 from pot
*** SUMMARY ***
Total pot $1.94 | Rake $0.07
Board [7d 4s Qh 7s 2d]
Seat 1: HumptyD (button) folded before Flop (didn't bet)
Seat 2: MrRooob9899 (small blind) showed [7c 7h] and won ($1.87) with four of a kind, Sevens
Seat 3: iliyan66 (big blind) folded before Flop
Seat 4: arlek1n22 folded before Flop (didn't bet)
Seat 5: cod4x folded before Flop (didn't bet)
Seat 6: hazedanger mucked [Qs Ks]

PokerStars Zoom Hand #251193467138:  Hold'em No Limit ($0.01/$0.02) - 2024/06/25 17:43:13 ET
Table 'Halley' 6-max Seat #1 is the button
Seat 1: lottokahe2 ($3.10 in chips)
Seat 2: carlaioana ($4.29 in chips)
Seat 3: cod4x ($2.06 in chips)
Seat 4: pampu1 ($3.83 in chips)
Seat 5: HumptyD ($2 in chips)
Seat 6: Bogdan_kiyev ($4.87 in chips)
carlaioana: posts small blind $0.01
cod4x: posts big blind $0.02
*** HOLE CARDS ***
Dealt to HumptyD [Ac 8d]
pampu1: folds
HumptyD: raises $0.04 to $0.06
Bogdan_kiyev: folds
lottokahe2: folds
carlaioana: calls $0.05
cod4x: folds
*** FLOP *** [Td Kc Ad]
carlaioana: bets $0.06
HumptyD: calls $0.06
*** TURN *** [Td Kc Ad] [6d]
carlaioana: bets $0.02
HumptyD: calls $0.02
*** RIVER *** [Td Kc Ad 6d] [Jc]
carlaioana: checks
HumptyD: bets $0.15
carlaioana: calls $0.15
*** SHOW DOWN ***
HumptyD: shows [Ac 8d] (a pair of Aces)
carlaioana: shows [Jh Tc] (two pair, Jacks and Tens)
carlaioana collected $0.58 from pot
*** SUMMARY ***
Total pot $0.60 | Rake $0.02
Board [Td Kc Ad 6d Jc]
Seat 1: lottokahe2 (button) folded before Flop (didn't bet)
Seat 2: carlaioana (small blind) showed [Jh Tc] and won ($0.58) with two pair, Jacks and Tens
Seat 3: cod4x (big blind) folded before Flop
Seat 4: pampu1 folded before Flop (didn't bet)
Seat 5: HumptyD showed [Ac 8d] and lost with a pair of Aces
Seat 6: Bogdan_kiyev folded before Flop (didn't bet)

PokerStars Zoom Hand #251193462935:  Hold'em No Limit ($0.01/$0.02) - 2024/06/25 17:42:58 ET
Table 'Halley' 6-max Seat #1 is the button
Seat 1: DonRazVan18 ($2.02 in chips)
Seat 2: HumptyD ($2 in chips)
Seat 3: Loosax ($1.73 in chips)
Seat 4: arlek1n22 ($1.93 in chips)
Seat 5: Agusy666 ($6.58 in chips)
Seat 6: mr.Lugaro ($3.46 in chips)
HumptyD: posts small blind $0.01
Loosax: posts big blind $0.02
*** HOLE CARDS ***
Dealt to HumptyD [8d Ks]
arlek1n22: raises $0.02 to $0.04
Agusy666: folds
mr.Lugaro: calls $0.04
DonRazVan18: calls $0.04
HumptyD: folds
Loosax: raises $0.14 to $0.18
arlek1n22: folds
mr.Lugaro: folds
DonRazVan18: calls $0.14
*** FLOP *** [Ah Ts Qd]
Loosax: bets $0.32
DonRazVan18: folds
Uncalled bet ($0.32) returned to Loosax
Loosax collected $0.43 from pot
Loosax: doesn't show hand
*** SUMMARY ***
Total pot $0.45 | Rake $0.02
Board [Ah Ts Qd]
Seat 1: DonRazVan18 (button) folded on the Flop
Seat 2: HumptyD (small blind) folded before Flop
Seat 3: Loosax (big blind) collected ($0.43)
Seat 4: arlek1n22 folded before Flop
Seat 5: Agusy666 folded before Flop (didn't bet)
Seat 6: mr.Lugaro folded before Flop

PokerStars Zoom Hand #251193477967:  Hold'em No Limit ($0.01/$0.02) - 2024/06/25 17:43:52 ET
Table 'Halley' 6-max Seat #1 is the button
Seat 1: carlaioana ($4.58 in chips)
Seat 2: JahromeT ($2.24 in chips)
Seat 3: marcelobr88888 ($1.91 in chips)
Seat 4: Agusy666 ($3.39 in chips)
Seat 5: maxteo15 ($6.50 in chips)
Seat 6: HumptyD ($2 in chips)
JahromeT: posts small blind $0.01
marcelobr88888: posts big blind $0.02
*** HOLE CARDS ***
Dealt to HumptyD [4s Ks]
Agusy666: folds
maxteo15: raises $0.03 to $0.05
HumptyD: folds
carlaioana: calls $0.05
JahromeT: folds
marcelobr88888: folds
*** FLOP *** [Kc Td 2d]
maxteo15: bets $0.07
carlaioana: folds
Uncalled bet ($0.07) returned to maxteo15
maxteo15 collected $0.13 from pot
maxteo15: doesn't show hand
*** SUMMARY ***
Total pot $0.13 | Rake $0
Board [Kc Td 2d]
Seat 1: carlaioana (button) folded on the Flop
Seat 2: JahromeT (small blind) folded before Flop
Seat 3: marcelobr88888 (big blind) folded before Flop
Seat 4: Agusy666 folded before Flop (didn't bet)
Seat 5: maxteo15 collected ($0.13)
Seat 6: HumptyD folded before Flop (didn't bet)

PokerStars Zoom Hand #251193480196:  Hold'em No Limit ($0.01/$0.02) - 2024/06/25 17:44:00 ET
Table 'Halley' 6-max Seat #1 is the button
Seat 1: Nomi Kopi ($1.45 in chips)
Seat 2: Emag fo Dog ($3.80 in chips)
Seat 3: HumptyD ($2 in chips)
Seat 4: Joey_PS2 ($2.56 in chips)
Seat 5: OLVPK ($2.41 in chips)
Seat 6: josesde ($2.14 in chips)
Emag fo Dog: posts small blind $0.01
HumptyD: posts big blind $0.02
*** HOLE CARDS ***
Dealt to HumptyD [8d 7c]
Joey_PS2: folds
OLVPK: raises $0.04 to $0.06
josesde: calls $0.06
Nomi Kopi: calls $0.06
Emag fo Dog: folds
HumptyD: folds
*** FLOP *** [Ks Kd 9s]
OLVPK: checks
josesde: checks
Nomi Kopi: checks
*** TURN *** [Ks Kd 9s] [Ts]
OLVPK: checks
josesde: bets $0.14
Nomi Kopi: folds
OLVPK: folds
Uncalled bet ($0.14) returned to josesde
josesde collected $0.20 from pot
josesde: doesn't show hand
*** SUMMARY ***
Total pot $0.21 | Rake $0.01
Board [Ks Kd 9s Ts]
Seat 1: Nomi Kopi (button) folded on the Turn
Seat 2: Emag fo Dog (small blind) folded before Flop
Seat 3: HumptyD (big blind) folded before Flop
Seat 4: Joey_PS2 folded before Flop (didn't bet)
Seat 5: OLVPK folded on the Turn
Seat 6: josesde collected ($0.20)

PokerStars Zoom Hand #251193488580:  Hold'em No Limit ($0.01/$0.02) - 2024/06/25 17:44:30 ET
Table 'Halley' 6-max Seat #1 is the button
Seat 1: mr.Lugaro ($2.68 in chips)
Seat 2: HumptyD ($2 in chips)
Seat 3: Cowden Calling ($2.71 in chips)
Seat 4: Odds76 ($0.93 in chips)
Seat 5: FERpokerNAND ($3.94 in chips)
Seat 6: Amazonia2010 ($2.01 in chips)
HumptyD: posts small blind $0.01
Cowden Calling: posts big blind $0.02
*** HOLE CARDS ***
Dealt to HumptyD [Ts Qc]
Odds76: folds
FERpokerNAND: folds
Amazonia2010: folds
mr.Lugaro: folds
HumptyD: calls $0.01
Cowden Calling: checks
*** FLOP *** [8h Jh 8s]
HumptyD: bets $0.02
Cowden Calling: folds
Uncalled bet ($0.02) returned to HumptyD
HumptyD collected $0.04 from pot
HumptyD: doesn't show hand
*** SUMMARY ***
Total pot $0.04 | Rake $0
Board [8h Jh 8s]
Seat 1: mr.Lugaro (button) folded before Flop (didn't bet)
Seat 2: HumptyD (small blind) collected ($0.04)
Seat 3: Cowden Calling (big blind) folded on the Flop
Seat 4: Odds76 folded before Flop (didn't bet)
Seat 5: FERpokerNAND folded before Flop (didn't bet)
Seat 6: Amazonia2010 folded before Flop (didn't bet)

PokerStars Zoom Hand #251193496513:  Hold'em No Limit ($0.01/$0.02) - 2024/06/25 17:44:58 ET
Table 'Halley' 6-max Seat #1 is the button
Seat 1: HumptyD ($2.02 in chips)
Seat 2: Bmillz11 ($2.33 in chips)
Seat 3: Odds76 ($2.13 in chips)
Seat 4: patrodden ($2.28 in chips)
Seat 5: Karfmad ($2.42 in chips)
Seat 6: LavrikSanta ($2.36 in chips)
Bmillz11: posts small blind $0.01
Odds76: posts big blind $0.02
*** HOLE CARDS ***
Dealt to HumptyD [3s 9h]
patrodden: folds
Karfmad: folds
LavrikSanta: folds
HumptyD: folds
Bmillz11: folds
Uncalled bet ($0.01) returned to Odds76
Odds76 collected $0.02 from pot
Odds76: doesn't show hand
*** SUMMARY ***
Total pot $0.02 | Rake $0
Seat 1: HumptyD (button) folded before Flop (didn't bet)
Seat 2: Bmillz11 (small blind) folded before Flop
Seat 3: Odds76 (big blind) collected ($0.02)
Seat 4: patrodden folded before Flop (didn't bet)
Seat 5: Karfmad folded before Flop (didn't bet)
Seat 6: LavrikSanta folded before Flop (didn't bet)

PokerStars Zoom Hand #251193487449:  Hold'em No Limit ($0.01/$0.02) - 2024/06/25 17:44:26 ET
Table 'Halley' 6-max Seat #1 is the button
Seat 1: mr.Lugaro ($3.39 in chips)
Seat 2: ksvlv18 ($0.71 in chips)
Seat 3: priidikas1 ($3.37 in chips)
Seat 4: HumptyD ($2 in chips)
Seat 5: siwyCFC ($1.58 in chips)
Seat 6: gasmar_29 ($2.17 in chips)
ksvlv18: posts small blind $0.01
priidikas1: posts big blind $0.02
*** HOLE CARDS ***
Dealt to HumptyD [7s 6c]
HumptyD: folds
siwyCFC: folds
gasmar_29: folds
mr.Lugaro: raises $0.03 to $0.05
ksvlv18: calls $0.04
priidikas1: folds
*** FLOP *** [Ks Td Jd]
ksvlv18: bets $0.04
mr.Lugaro: calls $0.04
*** TURN *** [Ks Td Jd] [Qh]
ksvlv18: checks
mr.Lugaro: bets $3.30 and is all-in
ksvlv18: calls $0.62 and is all-in
Uncalled bet ($2.68) returned to mr.Lugaro
*** RIVER *** [Ks Td Jd Qh] [Jc]
*** SHOW DOWN ***
ksvlv18: shows [8d 9d] (a straight, Nine to King)
mr.Lugaro: shows [Qc Ad] (a straight, Ten to Ace)
mr.Lugaro cashed out the hand for $1.06 | Cash Out Fee $0.02
*** SUMMARY ***
Total pot $1.44 | Rake $0.05
Board [Ks Td Jd Qh Jc]
Seat 1: mr.Lugaro (button) showed [Qc Ad] and won ($1.39) with a straight, Ten to Ace (pot not awarded as player cashed out)
Seat 2: ksvlv18 (small blind) showed [8d 9d] and lost with a straight, Nine to King
Seat 3: priidikas1 (big blind) folded before Flop
Seat 4: HumptyD folded before Flop (didn't bet)
Seat 5: siwyCFC folded before Flop (didn't bet)
Seat 6: gasmar_29 folded before Flop (didn't bet)

PokerStars Zoom Hand #251193504736:  Hold'em No Limit ($0.01/$0.02) - 2024/06/25 17:45:27 ET
Table 'Halley' 6-max Seat #1 is the button
Seat 1: MauDilly ($1.11 in chips)
Seat 2: iFRODOi ($2.39 in chips)
Seat 3: jaldini ($2.94 in chips)
Seat 4: f12022 ($2.14 in chips)
Seat 5: HumptyD ($2.02 in chips)
Seat 6: chri_zockt ($3.03 in chips)
iFRODOi: posts small blind $0.01
jaldini: posts big blind $0.02
*** HOLE CARDS ***
Dealt to HumptyD [3c Ks]
f12022: folds
HumptyD: folds
chri_zockt: folds
MauDilly: folds
iFRODOi: raises $0.02 to $0.04
jaldini: folds
Uncalled bet ($0.02) returned to iFRODOi
iFRODOi collected $0.04 from pot
iFRODOi: doesn't show hand
*** SUMMARY ***
Total pot $0.04 | Rake $0
Seat 1: MauDilly (button) folded before Flop (didn't bet)
Seat 2: iFRODOi (small blind) collected ($0.04)
Seat 3: jaldini (big blind) folded before Flop
Seat 4: f12022 folded before Flop (didn't bet)
Seat 5: HumptyD folded before Flop (didn't bet)
Seat 6: chri_zockt folded before Flop (didn't bet)

PokerStars Zoom Hand #251193506159:  Hold'em No Limit ($0.01/$0.02) - 2024/06/25 17:45:32 ET
Table 'Halley' 6-max Seat #1 is the button
Seat 1: ELJP ($2.53 in chips)
Seat 2: djulio94rike ($3.74 in chips)
Seat 3: HumptyD ($2.02 in chips)
Seat 4: death1198 ($1.87 in chips)
Seat 5: ARCUR1 ($3.30 in chips)
Seat 6: siwyCFC ($1.52 in chips)
djulio94rike: posts small blind $0.01
HumptyD: posts big blind $0.02
*** HOLE CARDS ***
Dealt to HumptyD [5d 2c]
death1198: folds
ARCUR1: folds
siwyCFC: raises $0.04 to $0.06
ELJP: folds
djulio94rike: folds
HumptyD: folds
Uncalled bet ($0.04) returned to siwyCFC
siwyCFC collected $0.05 from pot
siwyCFC: doesn't show hand
*** SUMMARY ***
Total pot $0.05 | Rake $0
Seat 1: ELJP (button) folded before Flop (didn't bet)
Seat 2: djulio94rike (small blind) folded before Flop
Seat 3: HumptyD (big blind) folded before Flop
Seat 4: death1198 folded before Flop (didn't bet)
Seat 5: ARCUR1 folded before Flop (didn't bet)
Seat 6: siwyCFC collected ($0.05)

PokerStars Zoom Hand #251193500465:  Hold'em No Limit ($0.01/$0.02) - 2024/06/25 17:45:13 ET
Table 'Halley' 6-max Seat #1 is the button
Seat 1: Reillyo123 ($2.19 in chips)
Seat 2: Jeandl0 ($3.86 in chips)
Seat 3: maxteo15 ($2.01 in chips)
Seat 4: Emag fo Dog ($3.69 in chips)
Seat 5: MauDilly ($1.11 in chips)
Seat 6: HumptyD ($2.02 in chips)
Jeandl0: posts small blind $0.01
maxteo15: posts big blind $0.02
*** HOLE CARDS ***
Dealt to HumptyD [Jh 6h]
Emag fo Dog: raises $0.04 to $0.06
MauDilly: folds
HumptyD: folds
Reillyo123: folds
Jeandl0: calls $0.05
maxteo15: calls $0.04
*** FLOP *** [Kc 7s Js]
Jeandl0: checks
maxteo15: checks
Emag fo Dog: checks
*** TURN *** [Kc 7s Js] [6d]
Jeandl0: checks
maxteo15: checks
Emag fo Dog: checks
*** RIVER *** [Kc 7s Js 6d] [3d]
Jeandl0: checks
maxteo15: checks
Emag fo Dog: checks
*** SHOW DOWN ***
Jeandl0: shows [9c Ac] (high card Ace)
maxteo15: shows [2h 2c] (a pair of Deuces)
Emag fo Dog: mucks hand
maxteo15 collected $0.17 from pot
*** SUMMARY ***
Total pot $0.18 | Rake $0.01
Board [Kc 7s Js 6d 3d]
Seat 1: Reillyo123 (button) folded before Flop (didn't bet)
Seat 2: Jeandl0 (small blind) showed [9c Ac] and lost with high card Ace
Seat 3: maxteo15 (big blind) showed [2h 2c] and won ($0.17) with a pair of Deuces
Seat 4: Emag fo Dog mucked [Ad 5s]
Seat 5: MauDilly folded before Flop (didn't bet)
Seat 6: HumptyD folded before Flop (didn't bet)

PokerStars Zoom Hand #251193498766:  Hold'em No Limit ($0.01/$0.02) - 2024/06/25 17:45:06 ET
Table 'Halley' 6-max Seat #1 is the button
Seat 1: Jeandl0 ($3.86 in chips)
Seat 2: g0ndarel91 ($1.09 in chips)
Seat 3: FERpokerNAND ($6.15 in chips)
Seat 4: JahromeT ($4.65 in chips)
Seat 5: HumptyD ($2.02 in chips)
Seat 6: chri_zockt ($2.70 in chips)
g0ndarel91: posts small blind $0.01
FERpokerNAND: posts big blind $0.02
*** HOLE CARDS ***
Dealt to HumptyD [6d 2s]
JahromeT: folds
HumptyD: folds
chri_zockt: raises $0.03 to $0.05
Jeandl0: folds
g0ndarel91: calls $0.04
FERpokerNAND: raises $0.03 to $0.08
chri_zockt: calls $0.03
g0ndarel91: calls $0.03
*** FLOP *** [7s 2d Jh]
g0ndarel91: checks
FERpokerNAND: checks
chri_zockt: bets $0.12
g0ndarel91: folds
FERpokerNAND: folds
Uncalled bet ($0.12) returned to chri_zockt
chri_zockt collected $0.23 from pot
chri_zockt: doesn't show hand
*** SUMMARY ***
Total pot $0.24 | Rake $0.01
Board [7s 2d Jh]
Seat 1: Jeandl0 (button) folded before Flop (didn't bet)
Seat 2: g0ndarel91 (small blind) folded on the Flop
Seat 3: FERpokerNAND (big blind) folded on the Flop
Seat 4: JahromeT folded before Flop (didn't bet)
Seat 5: HumptyD folded before Flop (didn't bet)
Seat 6: chri_zockt collected ($0.23)

PokerStars Zoom Hand #251193511756:  Hold'em No Limit ($0.01/$0.02) - 2024/06/25 17:45:52 ET
Table 'Halley' 6-max Seat #1 is the button
Seat 1: argent55 ($2.38 in chips)
Seat 2: MauDilly ($1.18 in chips)
Seat 3: Phil123515 ($2.37 in chips)
Seat 4: HumptyD ($2 in chips)
Seat 5: Agusy666 ($4.78 in chips)
Seat 6: viiv750 ($6.12 in chips)
MauDilly: posts small blind $0.01
Phil123515: posts big blind $0.02
*** HOLE CARDS ***
Dealt to HumptyD [3h Ts]
HumptyD: folds
Agusy666: folds
viiv750: folds
argent55: raises $0.03 to $0.05
MauDilly: folds
Phil123515: folds
Uncalled bet ($0.03) returned to argent55
argent55 collected $0.05 from pot
argent55: doesn't show hand
*** SUMMARY ***
Total pot $0.05 | Rake $0
Seat 1: argent55 (button) collected ($0.05)
Seat 2: MauDilly (small blind) folded before Flop
Seat 3: Phil123515 (big blind) folded before Flop
Seat 4: HumptyD folded before Flop (didn't bet)
Seat 5: Agusy666 folded before Flop (didn't bet)
Seat 6: viiv750 folded before Flop (didn't bet)

PokerStars Zoom Hand #251193513480:  Hold'em No Limit ($0.01/$0.02) - 2024/06/25 17:45:58 ET
Table 'Halley' 6-max Seat #1 is the button
Seat 1: gamw_TROIKA ($6.38 in chips)
Seat 2: HumptyD ($2 in chips)
Seat 3: Elwin Sariel ($2.20 in chips)
Seat 4: DONITA60 ($2.44 in chips)
Seat 5: Losimas(LT) ($2 in chips)
Seat 6: gomusin ($2.14 in chips)
HumptyD: posts small blind $0.01
Elwin Sariel: posts big blind $0.02
*** HOLE CARDS ***
Dealt to HumptyD [7d 3c]
DONITA60: folds
Losimas(LT): folds
gomusin: folds
gamw_TROIKA: raises $0.02 to $0.04
HumptyD: folds
Elwin Sariel: calls $0.02
*** FLOP *** [Tc 5c 6d]
Elwin Sariel: checks
gamw_TROIKA: bets $0.05
Elwin Sariel: folds
Uncalled bet ($0.05) returned to gamw_TROIKA
gamw_TROIKA collected $0.09 from pot
gamw_TROIKA: doesn't show hand
*** SUMMARY ***
Total pot $0.09 | Rake $0
Board [Tc 5c 6d]
Seat 1: gamw_TROIKA (button) collected ($0.09)
Seat 2: HumptyD (small blind) folded before Flop
Seat 3: Elwin Sariel (big blind) folded on the Flop
Seat 4: DONITA60 folded before Flop (didn't bet)
Seat 5: Losimas(LT) folded before Flop (didn't bet)
Seat 6: gomusin folded before Flop (didn't bet)

PokerStars Zoom Hand #251193516610:  Hold'em No Limit ($0.01/$0.02) - 2024/06/25 17:46:09 ET
Table 'Halley' 6-max Seat #1 is the button
Seat 1: HumptyD ($2 in chips)
Seat 2: chill.whale ($1.59 in chips)
Seat 3: 1VolkodavVDV ($1.38 in chips)
Seat 4: Gaigel ($2.25 in chips)
Seat 5: gasmar_29 ($2.15 in chips)
Seat 6: JFray756 ($1.98 in chips)
chill.whale: posts small blind $0.01
1VolkodavVDV: posts big blind $0.02
*** HOLE CARDS ***
Dealt to HumptyD [2d Js]
Gaigel: folds
gasmar_29: folds
JFray756: raises $0.04 to $0.06
HumptyD: folds
chill.whale: folds
1VolkodavVDV: calls $0.04
*** FLOP *** [2h 3d 3c]
1VolkodavVDV: checks
JFray756: checks
*** TURN *** [2h 3d 3c] [3s]
1VolkodavVDV: bets $0.07
JFray756: folds
Uncalled bet ($0.07) returned to 1VolkodavVDV
1VolkodavVDV collected $0.13 from pot
1VolkodavVDV: doesn't show hand
*** SUMMARY ***
Total pot $0.13 | Rake $0
Board [2h 3d 3c 3s]
Seat 1: HumptyD (button) folded before Flop (didn't bet)
Seat 2: chill.whale (small blind) folded before Flop
Seat 3: 1VolkodavVDV (big blind) collected ($0.13)
Seat 4: Gaigel folded before Flop (didn't bet)
Seat 5: gasmar_29 folded before Flop (didn't bet)
Seat 6: JFray756 folded on the Turn

PokerStars Zoom Hand #251193522491:  Hold'em No Limit ($0.01/$0.02) - 2024/06/25 17:46:31 ET
Table 'Halley' 6-max Seat #1 is the button
Seat 1: Bifizerocool ($4.09 in chips)
Seat 2: Malzuk ($9.11 in chips)
Seat 3: HumptyD ($2 in chips)
Seat 4: tolkien1986 ($2.11 in chips)
Seat 5: f12022 ($2.14 in chips)
Seat 6: iFRODOi ($2.59 in chips)
Malzuk: posts small blind $0.01
HumptyD: posts big blind $0.02
*** HOLE CARDS ***
Dealt to HumptyD [7c 9h]
tolkien1986: folds
f12022: folds
iFRODOi: raises $0.03 to $0.05
Bifizerocool: folds
Malzuk: folds
HumptyD: folds
Uncalled bet ($0.03) returned to iFRODOi
iFRODOi collected $0.05 from pot
iFRODOi: doesn't show hand
*** SUMMARY ***
Total pot $0.05 | Rake $0
Seat 1: Bifizerocool (button) folded before Flop (didn't bet)
Seat 2: Malzuk (small blind) folded before Flop
Seat 3: HumptyD (big blind) folded before Flop
Seat 4: tolkien1986 folded before Flop (didn't bet)
Seat 5: f12022 folded before Flop (didn't bet)
Seat 6: iFRODOi collected ($0.05)

PokerStars Zoom Hand #251193533063:  Hold'em No Limit ($0.01/$0.02) - 2024/06/25 17:47:08 ET
Table 'Halley' 6-max Seat #1 is the button
Seat 1: roby23 ($2.11 in chips)
Seat 2: 31Winston31 ($1.11 in chips)
Seat 3: 112294a ($2.02 in chips)
Seat 4: HumptyD ($2 in chips)
Seat 5: AT1LL4ZOREdd ($2.01 in chips)
Seat 6: f12022 ($2.18 in chips)
31Winston31: posts small blind $0.01
112294a: posts big blind $0.02
*** HOLE CARDS ***
Dealt to HumptyD [Kc 6h]
HumptyD: folds
AT1LL4ZOREdd: folds
f12022: folds
roby23: folds
31Winston31: folds
Uncalled bet ($0.01) returned to 112294a
112294a collected $0.02 from pot
112294a: doesn't show hand
*** SUMMARY ***
Total pot $0.02 | Rake $0
Seat 1: roby23 (button) folded before Flop (didn't bet)
Seat 2: 31Winston31 (small blind) folded before Flop
Seat 3: 112294a (big blind) collected ($0.02)
Seat 4: HumptyD folded before Flop (didn't bet)
Seat 5: AT1LL4ZOREdd folded before Flop (didn't bet)
Seat 6: f12022 folded before Flop (didn't bet)

PokerStars Zoom Hand #251193520804:  Hold'em No Limit ($0.01/$0.02) - 2024/06/25 17:46:25 ET
Table 'Halley' 6-max Seat #1 is the button
Seat 1: wejdig ($1.12 in chips)
Seat 2: Malzuk ($4.29 in chips)
Seat 3: MiniOverPower ($3.61 in chips)
Seat 4: JahromeT ($4.64 in chips)
Seat 5: cafferata3 ($2.54 in chips)
Seat 6: HumptyD ($2 in chips)
Malzuk: posts small blind $0.01
MiniOverPower: posts big blind $0.02
*** HOLE CARDS ***
Dealt to HumptyD [3h 6c]
JahromeT: folds
cafferata3: folds
HumptyD: folds
wejdig: folds
Malzuk: raises $0.04 to $0.06
MiniOverPower: calls $0.04
*** FLOP *** [5s 8d 8c]
Malzuk: checks
MiniOverPower: bets $0.02
Malzuk: folds
Uncalled bet ($0.02) returned to MiniOverPower
MiniOverPower collected $0.12 from pot
MiniOverPower: doesn't show hand
*** SUMMARY ***
Total pot $0.12 | Rake $0
Board [5s 8d 8c]
Seat 1: wejdig (button) folded before Flop (didn't bet)
Seat 2: Malzuk (small blind) folded on the Flop
Seat 3: MiniOverPower (big blind) collected ($0.12)
Seat 4: JahromeT folded before Flop (didn't bet)
Seat 5: cafferata3 folded before Flop (didn't bet)
Seat 6: HumptyD folded before Flop (didn't bet)

PokerStars Zoom Hand #251193531113:  Hold'em No Limit ($0.01/$0.02) - 2024/06/25 17:47:01 ET
Table 'Halley' 6-max Seat #1 is the button
Seat 1: ARCUR1 ($5.80 in chips)
Seat 2: LavrikSanta ($2 in chips)
Seat 3: Odds76 ($2.04 in chips)
Seat 4: HumptyD ($2 in chips)
Seat 5: NeoAsso ($2 in chips)
Seat 6: maldobex ($2.05 in chips)
LavrikSanta: posts small blind $0.01
Odds76: posts big blind $0.02
*** HOLE CARDS ***
Dealt to HumptyD [Qd 9c]
HumptyD: folds
NeoAsso: folds
maldobex has timed out
maldobex: folds
ARCUR1: folds
LavrikSanta: raises $0.04 to $0.06
Odds76: folds
Uncalled bet ($0.04) returned to LavrikSanta
LavrikSanta collected $0.04 from pot
LavrikSanta: doesn't show hand
*** SUMMARY ***
Total pot $0.04 | Rake $0
Seat 1: ARCUR1 (button) folded before Flop (didn't bet)
Seat 2: LavrikSanta (small blind) collected ($0.04)
Seat 3: Odds76 (big blind) folded before Flop
Seat 4: HumptyD folded before Flop (didn't bet)
Seat 5: NeoAsso folded before Flop (didn't bet)
Seat 6: maldobex folded before Flop (didn't bet)

PokerStars Zoom Hand #251193534456:  Hold'em No Limit ($0.01/$0.02) - 2024/06/25 17:47:13 ET
Table 'Halley' 6-max Seat #1 is the button
Seat 1: Haryel Hernande ($5.52 in chips)
Seat 2: HumptyD ($2 in chips)
Seat 3: hazedanger ($2.10 in chips)
Seat 4: ARCUR1 ($2 in chips)
Seat 5: Koresh153 ($1 in chips)
Seat 6: Heartb3ats ($1.20 in chips)
HumptyD: posts small blind $0.01
hazedanger: posts big blind $0.02
*** HOLE CARDS ***
Dealt to HumptyD [Qs Ah]
ARCUR1: folds
Koresh153: folds
Heartb3ats: raises $0.02 to $0.04
Haryel Hernande: folds
HumptyD: raises $0.10 to $0.14
hazedanger: folds
Heartb3ats: folds
Uncalled bet ($0.10) returned to HumptyD
HumptyD collected $0.10 from pot
HumptyD: doesn't show hand
*** SUMMARY ***
Total pot $0.10 | Rake $0
Seat 1: Haryel Hernande (button) folded before Flop (didn't bet)
Seat 2: HumptyD (small blind) collected ($0.10)
Seat 3: hazedanger (big blind) folded before Flop
Seat 4: ARCUR1 folded before Flop (didn't bet)
Seat 5: Koresh153 folded before Flop (didn't bet)
Seat 6: Heartb3ats folded before Flop

PokerStars Zoom Hand #251193543001:  Hold'em No Limit ($0.01/$0.02) - 2024/06/25 17:47:44 ET
Table 'Halley' 6-max Seat #1 is the button
Seat 1: HumptyD ($2.06 in chips)
Seat 2: cod4x ($2 in chips)
Seat 3: Reillyo123 ($1.86 in chips)
Seat 4: gasmar_29 ($2.56 in chips)
Seat 5: Mopsi995 ($1.84 in chips)
Seat 6: schievelbein ($1.81 in chips)
cod4x: posts small blind $0.01
Reillyo123: posts big blind $0.02
*** HOLE CARDS ***
Dealt to HumptyD [Ts 7h]
gasmar_29: folds
Mopsi995: folds
schievelbein: folds
HumptyD: folds
cod4x: folds
Uncalled bet ($0.01) returned to Reillyo123
Reillyo123 collected $0.02 from pot
Reillyo123: doesn't show hand
*** SUMMARY ***
Total pot $0.02 | Rake $0
Seat 1: HumptyD (button) folded before Flop (didn't bet)
Seat 2: cod4x (small blind) folded before Flop
Seat 3: Reillyo123 (big blind) collected ($0.02)
Seat 4: gasmar_29 folded before Flop (didn't bet)
Seat 5: Mopsi995 folded before Flop (didn't bet)
Seat 6: schievelbein folded before Flop (didn't bet)

PokerStars Zoom Hand #251193553979:  Hold'em No Limit ($0.01/$0.02) - 2024/06/25 17:48:23 ET
Table 'Halley' 6-max Seat #1 is the button
Seat 1: LavrikSanta ($2 in chips)
Seat 2: WindennN ($1.92 in chips)
Seat 3: HumptyD ($2 in chips)
Seat 4: niderlander ($4.36 in chips)
Seat 5: cod4x ($2.32 in chips)
Seat 6: gasmar_29 ($2.01 in chips)
WindennN: posts small blind $0.01
HumptyD: posts big blind $0.02
*** HOLE CARDS ***
Dealt to HumptyD [Qh Jh]
niderlander: folds
cod4x: folds
gasmar_29: folds
LavrikSanta: folds
WindennN: folds
Uncalled bet ($0.01) returned to HumptyD
HumptyD collected $0.02 from pot
HumptyD: doesn't show hand
*** SUMMARY ***
Total pot $0.02 | Rake $0
Seat 1: LavrikSanta (button) folded before Flop (didn't bet)
Seat 2: WindennN (small blind) folded before Flop
Seat 3: HumptyD (big blind) collected ($0.02)
Seat 4: niderlander folded before Flop (didn't bet)
Seat 5: cod4x folded before Flop (didn't bet)
Seat 6: gasmar_29 folded before Flop (didn't bet)

PokerStars Zoom Hand #251193559492:  Hold'em No Limit ($0.01/$0.02) - 2024/06/25 17:48:43 ET
Table 'Halley' 6-max Seat #1 is the button
Seat 1: damian196607 ($2 in chips)
Seat 2: HumptyD ($2.01 in chips)
Seat 3: MrRooob9899 ($1.89 in chips)
Seat 4: Money4meBr ($1.34 in chips)
Seat 5: NeoAsso ($2 in chips)
Seat 6: iFRODOi ($2.68 in chips)
HumptyD: posts small blind $0.01
MrRooob9899: posts big blind $0.02
*** HOLE CARDS ***
Dealt to HumptyD [5h Qh]
Money4meBr: folds
NeoAsso: folds
iFRODOi: folds
damian196607: folds
HumptyD: raises $0.04 to $0.06
MrRooob9899: folds
Uncalled bet ($0.04) returned to HumptyD
HumptyD collected $0.04 from pot
HumptyD: doesn't show hand
*** SUMMARY ***
Total pot $0.04 | Rake $0
Seat 1: damian196607 (button) folded before Flop (didn't bet)
Seat 2: HumptyD (small blind) collected ($0.04)
Seat 3: MrRooob9899 (big blind) folded before Flop
Seat 4: Money4meBr folded before Flop (didn't bet)
Seat 5: NeoAsso folded before Flop (didn't bet)
Seat 6: iFRODOi folded before Flop (didn't bet)

PokerStars Zoom Hand #251193545542:  Hold'em No Limit ($0.01/$0.02) - 2024/06/25 17:47:53 ET
Table 'Halley' 6-max Seat #1 is the button
Seat 1: gamw_TROIKA ($5.40 in chips)
Seat 2: pampu1 ($2 in chips)
Seat 3: maldobex ($2.05 in chips)
Seat 4: flqcommander ($2 in chips)
Seat 5: HumptyD ($2.06 in chips)
Seat 6: hazedanger ($1.26 in chips)
pampu1: posts small blind $0.01
maldobex: posts big blind $0.02
*** HOLE CARDS ***
Dealt to HumptyD [Jd Kh]
flqcommander: folds
HumptyD: raises $0.04 to $0.06
hazedanger: folds
gamw_TROIKA: calls $0.06
pampu1: raises $0.18 to $0.24
maldobex: folds
HumptyD: folds
gamw_TROIKA: calls $0.18
*** FLOP *** [3d 8h Kd]
pampu1: bets $0.16
gamw_TROIKA: calls $0.16
*** TURN *** [3d 8h Kd] [5d]
pampu1: bets $0.60
gamw_TROIKA: folds
Uncalled bet ($0.60) returned to pampu1
pampu1 collected $0.85 from pot
pampu1: doesn't show hand
*** SUMMARY ***
Total pot $0.88 | Rake $0.03
Board [3d 8h Kd 5d]
Seat 1: gamw_TROIKA (button) folded on the Turn
Seat 2: pampu1 (small blind) collected ($0.85)
Seat 3: maldobex (big blind) folded before Flop
Seat 4: flqcommander folded before Flop (didn't bet)
Seat 5: HumptyD folded before Flop
Seat 6: hazedanger folded before Flop (didn't bet)

PokerStars Zoom Hand #251193558687:  Hold'em No Limit ($0.01/$0.02) - 2024/06/25 17:48:40 ET
Table 'Halley' 6-max Seat #1 is the button
Seat 1: maxteo15 ($5.61 in chips)
Seat 2: Nomi Kopi ($1.76 in chips)
Seat 3: ELJP ($2.51 in chips)
Seat 4: JORDYLEON ($3.81 in chips)
Seat 5: josesde ($2.17 in chips)
Seat 6: HumptyD ($2.01 in chips)
Nomi Kopi: posts small blind $0.01
ELJP: posts big blind $0.02
*** HOLE CARDS ***
Dealt to HumptyD [7s 2d]
JORDYLEON: folds
josesde: calls $0.02
HumptyD: folds
maxteo15: raises $0.07 to $0.09
Nomi Kopi: folds
ELJP: folds
josesde: calls $0.07
*** FLOP *** [Td 2c 9d]
josesde: checks
maxteo15: checks
*** TURN *** [Td 2c 9d] [Ks]
josesde: bets $0.08
maxteo15: folds
Uncalled bet ($0.08) returned to josesde
josesde collected $0.20 from pot
josesde: doesn't show hand
*** SUMMARY ***
Total pot $0.21 | Rake $0.01
Board [Td 2c 9d Ks]
Seat 1: maxteo15 (button) folded on the Turn
Seat 2: Nomi Kopi (small blind) folded before Flop
Seat 3: ELJP (big blind) folded before Flop
Seat 4: JORDYLEON folded before Flop (didn't bet)
Seat 5: josesde collected ($0.20)
Seat 6: HumptyD folded before Flop (didn't bet)

PokerStars Zoom Hand #251193567875:  Hold'em No Limit ($0.01/$0.02) - 2024/06/25 17:49:13 ET
Table 'Halley' 6-max Seat #1 is the button
Seat 1: iFRODOi ($2.22 in chips)
Seat 2: JORDYLEON ($3.80 in chips)
Seat 3: Paya_31 ($2.32 in chips)
Seat 4: HumptyD ($2.03 in chips)
Seat 5: DonRazVan18 ($2.70 in chips)
Seat 6: tolkien1986 ($2 in chips)
JORDYLEON: posts small blind $0.01
Paya_31: posts big blind $0.02
*** HOLE CARDS ***
Dealt to HumptyD [Qs 9h]
HumptyD: folds
DonRazVan18: folds
tolkien1986: folds
iFRODOi: raises $0.03 to $0.05
JORDYLEON: folds
Paya_31: folds
Uncalled bet ($0.03) returned to iFRODOi
iFRODOi collected $0.05 from pot
iFRODOi: doesn't show hand
*** SUMMARY ***
Total pot $0.05 | Rake $0
Seat 1: iFRODOi (button) collected ($0.05)
Seat 2: JORDYLEON (small blind) folded before Flop
Seat 3: Paya_31 (big blind) folded before Flop
Seat 4: HumptyD folded before Flop (didn't bet)
Seat 5: DonRazVan18 folded before Flop (didn't bet)
Seat 6: tolkien1986 folded before Flop (didn't bet)

PokerStars Zoom Hand #251193563119:  Hold'em No Limit ($0.01/$0.02) - 2024/06/25 17:48:56 ET
Table 'Halley' 6-max Seat #1 is the button
Seat 1: Nomi Kopi ($1.44 in chips)
Seat 2: 112294a ($2.03 in chips)
Seat 3: jaldini ($2.02 in chips)
Seat 4: Master Jekku ($2 in chips)
Seat 5: HumptyD ($2.03 in chips)
Seat 6: maxteo15 ($5.01 in chips)
112294a: posts small blind $0.01
jaldini: posts big blind $0.02
*** HOLE CARDS ***
Dealt to HumptyD [9h 5c]
Master Jekku: folds
HumptyD: folds
maxteo15: folds
Nomi Kopi: folds
112294a: raises $0.04 to $0.06
jaldini: calls $0.04
*** FLOP *** [6s 4h Th]
112294a: bets $0.06
jaldini: calls $0.06
*** TURN *** [6s 4h Th] [Qd]
112294a: checks
jaldini: checks
*** RIVER *** [6s 4h Th Qd] [Qh]
112294a: checks
jaldini: bets $0.14
112294a: calls $0.14
*** SHOW DOWN ***
jaldini: shows [2s 5s] (a pair of Queens)
112294a: shows [8d Qs] (three of a kind, Queens)
112294a collected $0.50 from pot
*** SUMMARY ***
Total pot $0.52 | Rake $0.02
Board [6s 4h Th Qd Qh]
Seat 1: Nomi Kopi (button) folded before Flop (didn't bet)
Seat 2: 112294a (small blind) showed [8d Qs] and won ($0.50) with three of a kind, Queens
Seat 3: jaldini (big blind) showed [2s 5s] and lost with a pair of Queens
Seat 4: Master Jekku folded before Flop (didn't bet)
Seat 5: HumptyD folded before Flop (didn't bet)
Seat 6: maxteo15 folded before Flop (didn't bet)

PokerStars Zoom Hand #251193569541:  Hold'em No Limit ($0.01/$0.02) - 2024/06/25 17:49:19 ET
Table 'Halley' 6-max Seat #1 is the button
Seat 1: jaldini ($3.84 in chips)
Seat 2: TSCardinals ($2.06 in chips)
Seat 3: HumptyD ($2.03 in chips)
Seat 4: Paya_31 ($3.36 in chips)
Seat 5: Her2827 ($2.63 in chips)
Seat 6: Ryphor ($2.31 in chips)
TSCardinals: posts small blind $0.01
HumptyD: posts big blind $0.02
*** HOLE CARDS ***
Dealt to HumptyD [Kd 6h]
Paya_31: raises $0.03 to $0.05
Her2827: folds
Ryphor: calls $0.05
jaldini: folds
TSCardinals: folds
HumptyD: folds
*** FLOP *** [Jc 4s 8c]
Paya_31: bets $0.03
Ryphor: calls $0.03
*** TURN *** [Jc 4s 8c] [5h]
Paya_31: bets $0.14
Ryphor: folds
Uncalled bet ($0.14) returned to Paya_31
Paya_31 collected $0.18 from pot
Paya_31: doesn't show hand
*** SUMMARY ***
Total pot $0.19 | Rake $0.01
Board [Jc 4s 8c 5h]
Seat 1: jaldini (button) folded before Flop (didn't bet)
Seat 2: TSCardinals (small blind) folded before Flop
Seat 3: HumptyD (big blind) folded before Flop
Seat 4: Paya_31 collected ($0.18)
Seat 5: Her2827 folded before Flop (didn't bet)
Seat 6: Ryphor folded on the Turn

PokerStars Zoom Hand #251193575917:  Hold'em No Limit ($0.01/$0.02) - 2024/06/25 17:49:42 ET
Table 'Halley' 6-max Seat #1 is the button
Seat 1: Leftover448 ($1.73 in chips)
Seat 2: HumptyD ($2.01 in chips)
Seat 3: Lila6914 ($2 in chips)
Seat 4: Emag fo Dog ($3.55 in chips)
Seat 5: Odds76 ($2.22 in chips)
Seat 6: AT1LL4ZOREdd ($7.75 in chips)
HumptyD: posts small blind $0.01
Lila6914: posts big blind $0.02
*** HOLE CARDS ***
Dealt to HumptyD [7c 6s]
Emag fo Dog: raises $0.04 to $0.06
Odds76: folds
AT1LL4ZOREdd: raises $0.12 to $0.18
Leftover448: folds
HumptyD: folds
Lila6914: folds
Emag fo Dog: folds
Uncalled bet ($0.12) returned to AT1LL4ZOREdd
AT1LL4ZOREdd collected $0.15 from pot
AT1LL4ZOREdd: doesn't show hand
*** SUMMARY ***
Total pot $0.15 | Rake $0
Seat 1: Leftover448 (button) folded before Flop (didn't bet)
Seat 2: HumptyD (small blind) folded before Flop
Seat 3: Lila6914 (big blind) folded before Flop
Seat 4: Emag fo Dog folded before Flop
Seat 5: Odds76 folded before Flop (didn't bet)
Seat 6: AT1LL4ZOREdd collected ($0.15)

PokerStars Zoom Hand #251193574763:  Hold'em No Limit ($0.01/$0.02) - 2024/06/25 17:49:38 ET
Table 'Halley' 6-max Seat #1 is the button
Seat 1: Koresh153 ($1 in chips)
Seat 2: DONITA60 ($4.03 in chips)
Seat 3: dundee is blue ($0.95 in chips)
Seat 4: TSCardinals ($2.09 in chips)
Seat 5: riogla ($5.53 in chips)
Seat 6: HumptyD ($2.01 in chips)
DONITA60: posts small blind $0.01
dundee is blue: posts big blind $0.02
*** HOLE CARDS ***
Dealt to HumptyD [Kc 3s]
TSCardinals: folds
riogla: folds
HumptyD: folds
Koresh153: raises $0.04 to $0.06
DONITA60: folds
dundee is blue: calls $0.04
*** FLOP *** [5d 9c Ks]
dundee is blue: checks
Koresh153: bets $0.09
dundee is blue: calls $0.09
*** TURN *** [5d 9c Ks] [4d]
dundee is blue: checks
Koresh153: bets $0.85 and is all-in
dundee is blue: folds
Uncalled bet ($0.85) returned to Koresh153
Koresh153 collected $0.30 from pot
Koresh153: doesn't show hand
*** SUMMARY ***
Total pot $0.31 | Rake $0.01
Board [5d 9c Ks 4d]
Seat 1: Koresh153 (button) collected ($0.30)
Seat 2: DONITA60 (small blind) folded before Flop
Seat 3: dundee is blue (big blind) folded on the Turn
Seat 4: TSCardinals folded before Flop (didn't bet)
Seat 5: riogla folded before Flop (didn't bet)
Seat 6: HumptyD folded before Flop (didn't bet)

PokerStars Zoom Hand #251193564485:  Hold'em No Limit ($0.01/$0.02) - 2024/06/25 17:49:01 ET
Table 'Halley' 6-max Seat #1 is the button
Seat 1: HumptyD ($2.03 in chips)
Seat 2: lottokahe2 ($3.04 in chips)
Seat 3: 112294a ($2.19 in chips)
Seat 4: DONITA60 ($2.34 in chips)
Seat 5: argent55 ($3.81 in chips)
Seat 6: maldobex ($2.02 in chips)
lottokahe2: posts small blind $0.01
112294a: posts big blind $0.02
*** HOLE CARDS ***
Dealt to HumptyD [Tc 5h]
DONITA60: folds
argent55: folds
maldobex: raises $0.03 to $0.05
HumptyD: folds
lottokahe2: calls $0.04
112294a: folds
*** FLOP *** [9c 9d 5d]
lottokahe2: checks
maldobex: bets $0.06
lottokahe2: calls $0.06
*** TURN *** [9c 9d 5d] [8c]
lottokahe2: checks
maldobex: bets $0.12
lottokahe2: calls $0.12
*** RIVER *** [9c 9d 5d 8c] [2h]
lottokahe2: checks
maldobex: bets $0.23
lottokahe2: folds
Uncalled bet ($0.23) returned to maldobex
maldobex collected $0.46 from pot
maldobex: doesn't show hand
*** SUMMARY ***
Total pot $0.48 | Rake $0.02
Board [9c 9d 5d 8c 2h]
Seat 1: HumptyD (button) folded before Flop (didn't bet)
Seat 2: lottokahe2 (small blind) folded on the River
Seat 3: 112294a (big blind) folded before Flop
Seat 4: DONITA60 folded before Flop (didn't bet)
Seat 5: argent55 folded before Flop (didn't bet)
Seat 6: maldobex collected ($0.46)

PokerStars Zoom Hand #251193579544:  Hold'em No Limit ($0.01/$0.02) - 2024/06/25 17:49:55 ET
Table 'Halley' 6-max Seat #1 is the button
Seat 1: flqcommander ($2.30 in chips)
Seat 2: LavrikSanta ($2.14 in chips)
Seat 3: GoldeN0330 ($2 in chips)
Seat 4: HumptyD ($2 in chips)
Seat 5: cod4x ($2.25 in chips)
Seat 6: fugadeluz ($5.83 in chips)
LavrikSanta: posts small blind $0.01
GoldeN0330: posts big blind $0.02
*** HOLE CARDS ***
Dealt to HumptyD [Ks 7c]
HumptyD: folds
cod4x: folds
fugadeluz: raises $0.02 to $0.04
flqcommander: folds
LavrikSanta: folds
GoldeN0330: folds
Uncalled bet ($0.02) returned to fugadeluz
fugadeluz collected $0.05 from pot
fugadeluz: doesn't show hand
*** SUMMARY ***
Total pot $0.05 | Rake $0
Seat 1: flqcommander (button) folded before Flop (didn't bet)
Seat 2: LavrikSanta (small blind) folded before Flop
Seat 3: GoldeN0330 (big blind) folded before Flop
Seat 4: HumptyD folded before Flop (didn't bet)
Seat 5: cod4x folded before Flop (didn't bet)
Seat 6: fugadeluz collected ($0.05)

PokerStars Zoom Hand #251193581600:  Hold'em No Limit ($0.01/$0.02) - 2024/06/25 17:50:02 ET
Table 'Halley' 6-max Seat #1 is the button
Seat 1: HumptyD ($2 in chips)
Seat 2: DonRazVan18 ($2.17 in chips)
Seat 3: pATU8D ($3.10 in chips)
Seat 4: YiannisKar ($2.14 in chips)
Seat 5: Losimas(LT) ($2 in chips)
Seat 6: gomusin ($1.93 in chips)
DonRazVan18: posts small blind $0.01
pATU8D: posts big blind $0.02
*** HOLE CARDS ***
Dealt to HumptyD [Tc 9h]
YiannisKar: folds
Losimas(LT): folds
gomusin: raises $0.03 to $0.05
HumptyD: folds
DonRazVan18: raises $0.15 to $0.20
pATU8D: folds
gomusin: folds
Uncalled bet ($0.15) returned to DonRazVan18
DonRazVan18 collected $0.12 from pot
DonRazVan18: doesn't show hand
*** SUMMARY ***
Total pot $0.12 | Rake $0
Seat 1: HumptyD (button) folded before Flop (didn't bet)
Seat 2: DonRazVan18 (small blind) collected ($0.12)
Seat 3: pATU8D (big blind) folded before Flop
Seat 4: YiannisKar folded before Flop (didn't bet)
Seat 5: Losimas(LT) folded before Flop (didn't bet)
Seat 6: gomusin folded before Flop

PokerStars Zoom Hand #251193594108:  Hold'em No Limit ($0.01/$0.02) - 2024/06/25 17:50:47 ET
Table 'Halley' 6-max Seat #1 is the button
Seat 1: MrRooob9899 ($1.98 in chips)
Seat 2: Tricolor1980 ($1 in chips)
Seat 3: Marcus579 ($2.24 in chips)
Seat 4: HumptyD ($2 in chips)
Seat 5: Jeandl0 ($1.89 in chips)
Seat 6: Master Jekku ($2 in chips)
Tricolor1980: posts small blind $0.01
Marcus579: posts big blind $0.02
*** HOLE CARDS ***
Dealt to HumptyD [Qc Kh]
HumptyD: raises $0.04 to $0.06
Jeandl0: folds
Master Jekku: folds
MrRooob9899: calls $0.06
Tricolor1980: folds
Marcus579: folds
*** FLOP *** [6s 9c Qd]
HumptyD: bets $0.07
MrRooob9899: folds
Uncalled bet ($0.07) returned to HumptyD
HumptyD collected $0.14 from pot
HumptyD: doesn't show hand
*** SUMMARY ***
Total pot $0.15 | Rake $0.01
Board [6s 9c Qd]
Seat 1: MrRooob9899 (button) folded on the Flop
Seat 2: Tricolor1980 (small blind) folded before Flop
Seat 3: Marcus579 (big blind) folded before Flop
Seat 4: HumptyD collected ($0.14)
Seat 5: Jeandl0 folded before Flop (didn't bet)
Seat 6: Master Jekku folded before Flop (didn't bet)

PokerStars Zoom Hand #251193592381:  Hold'em No Limit ($0.01/$0.02) - 2024/06/25 17:50:41 ET
Table 'Halley' 6-max Seat #1 is the button
Seat 1: LavrikSanta ($2.02 in chips)
Seat 2: mazzzzzey ($0.81 in chips)
Seat 3: Cowden Calling ($3.01 in chips)
Seat 4: Losimas(LT) ($2.25 in chips)
Seat 5: JahromeT ($5.17 in chips)
Seat 6: HumptyD ($2 in chips)
mazzzzzey: posts small blind $0.01
Cowden Calling: posts big blind $0.02
*** HOLE CARDS ***
Dealt to HumptyD [9d 5h]
Losimas(LT): folds
JahromeT: folds
HumptyD: folds
LavrikSanta: raises $0.03 to $0.05
mazzzzzey: folds
Cowden Calling: calls $0.03
*** FLOP *** [Kc 5c 3h]
Cowden Calling: checks
LavrikSanta: bets $0.06
Cowden Calling: calls $0.06
*** TURN *** [Kc 5c 3h] [Jc]
Cowden Calling: checks
LavrikSanta: checks
*** RIVER *** [Kc 5c 3h Jc] [Kh]
Cowden Calling: bets $0.11
LavrikSanta: calls $0.11
*** SHOW DOWN ***
Cowden Calling: shows [6c 3c] (a flush, King high)
LavrikSanta: mucks hand
Cowden Calling collected $0.43 from pot
*** SUMMARY ***
Total pot $0.45 | Rake $0.02
Board [Kc 5c 3h Jc Kh]
Seat 1: LavrikSanta (button) mucked [Kd Qs]
Seat 2: mazzzzzey (small blind) folded before Flop
Seat 3: Cowden Calling (big blind) showed [6c 3c] and won ($0.43) with a flush, King high
Seat 4: Losimas(LT) folded before Flop (didn't bet)
Seat 5: JahromeT folded before Flop (didn't bet)
Seat 6: HumptyD folded before Flop (didn't bet)

PokerStars Zoom Hand #251193599606:  Hold'em No Limit ($0.01/$0.02) - 2024/06/25 17:51:07 ET
Table 'Halley' 6-max Seat #1 is the button
Seat 1: josesde ($0.93 in chips)
Seat 2: pandaman9010 ($1.08 in chips)
Seat 3: Karfmad ($2.18 in chips)
Seat 4: hazedanger ($1.62 in chips)
Seat 5: HumptyD ($2.08 in chips)
Seat 6: YiannisKar ($2.07 in chips)
pandaman9010: posts small blind $0.01
Karfmad: posts big blind $0.02
*** HOLE CARDS ***
Dealt to HumptyD [3h 5c]
hazedanger: folds
HumptyD: folds
YiannisKar: folds
josesde: calls $0.02
pandaman9010: folds
Karfmad: checks
*** FLOP *** [9d 2d Qs]
Karfmad: checks
josesde: bets $0.06
Karfmad: folds
Uncalled bet ($0.06) returned to josesde
josesde collected $0.05 from pot
josesde: doesn't show hand
*** SUMMARY ***
Total pot $0.05 | Rake $0
Board [9d 2d Qs]
Seat 1: josesde (button) collected ($0.05)
Seat 2: pandaman9010 (small blind) folded before Flop
Seat 3: Karfmad (big blind) folded on the Flop
Seat 4: hazedanger folded before Flop (didn't bet)
Seat 5: HumptyD folded before Flop (didn't bet)
Seat 6: YiannisKar folded before Flop (didn't bet)

PokerStars Zoom Hand #251193600973:  Hold'em No Limit ($0.01/$0.02) - 2024/06/25 17:51:12 ET
Table 'Halley' 6-max Seat #1 is the button
Seat 1: THXforFoldin ($2.12 in chips)
Seat 2: HumptyD ($2.08 in chips)
Seat 3: julito39 ($1.97 in chips)
Seat 4: Bifizerocool ($3.69 in chips)
Seat 5: AT1LL4ZOREdd ($7.86 in chips)
Seat 6: pandaman9010 ($1.07 in chips)
HumptyD: posts small blind $0.01
julito39: posts big blind $0.02
*** HOLE CARDS ***
Dealt to HumptyD [6h 8s]
Bifizerocool: folds
AT1LL4ZOREdd: folds
pandaman9010: folds
THXforFoldin: folds
HumptyD: calls $0.01
julito39: raises $0.04 to $0.06
HumptyD: folds
Uncalled bet ($0.04) returned to julito39
julito39 collected $0.04 from pot
julito39: doesn't show hand
*** SUMMARY ***
Total pot $0.04 | Rake $0
Seat 1: THXforFoldin (button) folded before Flop (didn't bet)
Seat 2: HumptyD (small blind) folded before Flop
Seat 3: julito39 (big blind) collected ($0.04)
Seat 4: Bifizerocool folded before Flop (didn't bet)
Seat 5: AT1LL4ZOREdd folded before Flop (didn't bet)
Seat 6: pandaman9010 folded before Flop (didn't bet)

PokerStars Zoom Hand #251193585157:  Hold'em No Limit ($0.01/$0.02) - 2024/06/25 17:50:15 ET
Table 'Halley' 6-max Seat #1 is the button
Seat 1: g0ndarel91 ($1.35 in chips)
Seat 2: dundee is blue ($0.80 in chips)
Seat 3: HumptyD ($2 in chips)
Seat 4: Reillyo123 ($2.19 in chips)
Seat 5: bizbakol ($0.51 in chips)
Seat 6: ARCUR1 ($5.94 in chips)
dundee is blue: posts small blind $0.01
HumptyD: posts big blind $0.02
*** HOLE CARDS ***
Dealt to HumptyD [5c Qh]
Reillyo123: folds
bizbakol: folds
ARCUR1: raises $0.03 to $0.05
g0ndarel91: raises $0.13 to $0.18
dundee is blue: folds
HumptyD: folds
ARCUR1: calls $0.13
*** FLOP *** [8h 7h 9c]
ARCUR1: checks
g0ndarel91: checks
*** TURN *** [8h 7h 9c] [7c]
ARCUR1: checks
g0ndarel91: checks
*** RIVER *** [8h 7h 9c 7c] [8c]
ARCUR1: checks
g0ndarel91: checks
*** SHOW DOWN ***
ARCUR1: shows [4s As] (two pair, Eights and Sevens)
g0ndarel91: shows [Qd Ah] (two pair, Eights and Sevens)
ARCUR1 collected $0.19 from pot
g0ndarel91 collected $0.19 from pot
*** SUMMARY ***
Total pot $0.39 | Rake $0.01
Board [8h 7h 9c 7c 8c]
Seat 1: g0ndarel91 (button) showed [Qd Ah] and won ($0.19) with two pair, Eights and Sevens
Seat 2: dundee is blue (small blind) folded before Flop
Seat 3: HumptyD (big blind) folded before Flop
Seat 4: Reillyo123 folded before Flop (didn't bet)
Seat 5: bizbakol folded before Flop (didn't bet)
Seat 6: ARCUR1 showed [4s As] and won ($0.19) with two pair, Eights and Sevens

PokerStars Zoom Hand #251193608837:  Hold'em No Limit ($0.01/$0.02) - 2024/06/25 17:51:40 ET
Table 'Halley' 6-max Seat #1 is the button
Seat 1: 31Winston31 ($2.08 in chips)
Seat 2: Elwin Sariel ($2.15 in chips)
Seat 3: Her2827 ($3.40 in chips)
Seat 4: HumptyD ($2.06 in chips)
Seat 5: Cowden Calling ($3.21 in chips)
Seat 6: Jeandl0 ($8.14 in chips)
Elwin Sariel: posts small blind $0.01
Her2827: posts big blind $0.02
*** HOLE CARDS ***
Dealt to HumptyD [4d 5s]
HumptyD: folds
Cowden Calling: folds
Jeandl0: folds
31Winston31: folds
Elwin Sariel: folds
Uncalled bet ($0.01) returned to Her2827
Her2827 collected $0.02 from pot
Her2827: doesn't show hand
*** SUMMARY ***
Total pot $0.02 | Rake $0
Seat 1: 31Winston31 (button) folded before Flop (didn't bet)
Seat 2: Elwin Sariel (small blind) folded before Flop
Seat 3: Her2827 (big blind) collected ($0.02)
Seat 4: HumptyD folded before Flop (didn't bet)
Seat 5: Cowden Calling folded before Flop (didn't bet)
Seat 6: Jeandl0 folded before Flop (didn't bet)

PokerStars Zoom Hand #251193610716:  Hold'em No Limit ($0.01/$0.02) - 2024/06/25 17:51:47 ET
Table 'Halley' 6-max Seat #1 is the button
Seat 1: HumptyD ($2.06 in chips)
Seat 2: keoo341 ($2.02 in chips)
Seat 3: carlaioana ($5.34 in chips)
Seat 4: Ryphor ($2.46 in chips)
Seat 5: bizbakol ($0.44 in chips)
Seat 6: panpaniscus1 ($1.84 in chips)
keoo341: posts small blind $0.01
carlaioana: posts big blind $0.02
*** HOLE CARDS ***
Dealt to HumptyD [Th 8c]
Ryphor: folds
bizbakol: folds
panpaniscus1: folds
HumptyD: folds
keoo341: folds
Uncalled bet ($0.01) returned to carlaioana
carlaioana collected $0.02 from pot
carlaioana: doesn't show hand
*** SUMMARY ***
Total pot $0.02 | Rake $0
Seat 1: HumptyD (button) folded before Flop (didn't bet)
Seat 2: keoo341 (small blind) folded before Flop
Seat 3: carlaioana (big blind) collected ($0.02)
Seat 4: Ryphor folded before Flop (didn't bet)
Seat 5: bizbakol folded before Flop (didn't bet)
Seat 6: panpaniscus1 folded before Flop (didn't bet)

PokerStars Zoom Hand #251193612088:  Hold'em No Limit ($0.01/$0.02) - 2024/06/25 17:51:52 ET
Table 'Halley' 6-max Seat #1 is the button
Seat 1: Overcoystream ($2 in chips)
Seat 2: sound_only ($2 in chips)
Seat 3: TSCardinals ($2.13 in chips)
Seat 4: argent55 ($2.04 in chips)
Seat 5: maldobex ($2.83 in chips)
Seat 6: HumptyD ($2.06 in chips)
sound_only: posts small blind $0.01
TSCardinals: posts big blind $0.02
*** HOLE CARDS ***
Dealt to HumptyD [Qc 3d]
argent55: folds
maldobex: folds
HumptyD: folds
Overcoystream: folds
sound_only: folds
Uncalled bet ($0.01) returned to TSCardinals
TSCardinals collected $0.02 from pot
TSCardinals: doesn't show hand
*** SUMMARY ***
Total pot $0.02 | Rake $0
Seat 1: Overcoystream (button) folded before Flop (didn't bet)
Seat 2: sound_only (small blind) folded before Flop
Seat 3: TSCardinals (big blind) collected ($0.02)
Seat 4: argent55 folded before Flop (didn't bet)
Seat 5: maldobex folded before Flop (didn't bet)
Seat 6: HumptyD folded before Flop (didn't bet)

PokerStars Zoom Hand #251193615100:  Hold'em No Limit ($0.01/$0.02) - 2024/06/25 17:52:03 ET
Table 'Halley' 6-max Seat #1 is the button
Seat 1: GUILLE 1308 ($0.40 in chips)
Seat 2: patrodden ($2.45 in chips)
Seat 3: HumptyD ($2.06 in chips)
Seat 4: Malzuk ($2.36 in chips)
Seat 5: bizbakol ($0.42 in chips)
Seat 6: manon0512 ($1.01 in chips)
patrodden: posts small blind $0.01
HumptyD: posts big blind $0.02
*** HOLE CARDS ***
Dealt to HumptyD [Jc 8d]
Malzuk: folds
bizbakol: folds
manon0512: folds
GUILLE 1308: calls $0.02
patrodden: raises $0.04 to $0.06
HumptyD: folds
GUILLE 1308: calls $0.04
*** FLOP *** [4h 3h Qc]
patrodden: checks
GUILLE 1308: bets $0.34 and is all-in
patrodden: folds
Uncalled bet ($0.34) returned to GUILLE 1308
GUILLE 1308 collected $0.14 from pot
GUILLE 1308: doesn't show hand
*** SUMMARY ***
Total pot $0.14 | Rake $0
Board [4h 3h Qc]
Seat 1: GUILLE 1308 (button) collected ($0.14)
Seat 2: patrodden (small blind) folded on the Flop
Seat 3: HumptyD (big blind) folded before Flop
Seat 4: Malzuk folded before Flop (didn't bet)
Seat 5: bizbakol folded before Flop (didn't bet)
Seat 6: manon0512 folded before Flop (didn't bet)

PokerStars Zoom Hand #251193618103:  Hold'em No Limit ($0.01/$0.02) - 2024/06/25 17:52:14 ET
Table 'Halley' 6-max Seat #1 is the button
Seat 1: Probe_BeTT ($1.68 in chips)
Seat 2: rimtis ($1.07 in chips)
Seat 3: flqcommander ($2.36 in chips)
Seat 4: NeoAsso ($2.01 in chips)
Seat 5: HumptyD ($2.04 in chips)
Seat 6: QuadPokerBR ($1.37 in chips)
rimtis: posts small blind $0.01
flqcommander: posts big blind $0.02
*** HOLE CARDS ***
Dealt to HumptyD [2d 7c]
NeoAsso: folds
HumptyD: folds
QuadPokerBR: folds
Probe_BeTT: folds
rimtis: raises $0.04 to $0.06
flqcommander: raises $0.14 to $0.20
rimtis: folds
Uncalled bet ($0.14) returned to flqcommander
flqcommander collected $0.12 from pot
flqcommander: doesn't show hand
*** SUMMARY ***
Total pot $0.12 | Rake $0
Seat 1: Probe_BeTT (button) folded before Flop (didn't bet)
Seat 2: rimtis (small blind) folded before Flop
Seat 3: flqcommander (big blind) collected ($0.12)
Seat 4: NeoAsso folded before Flop (didn't bet)
Seat 5: HumptyD folded before Flop (didn't bet)
Seat 6: QuadPokerBR folded before Flop (didn't bet)

PokerStars Zoom Hand #251193619807:  Hold'em No Limit ($0.01/$0.02) - 2024/06/25 17:52:20 ET
Table 'Halley' 6-max Seat #1 is the button
Seat 1: gamw_TROIKA ($5.32 in chips)
Seat 2: priidikas1 ($2.31 in chips)
Seat 3: DonRazVan18 ($4.55 in chips)
Seat 4: AT1LL4ZOREdd ($2.96 in chips)
Seat 5: HumptyD ($2.04 in chips)
Seat 6: LavrikSanta ($2.01 in chips)
priidikas1: posts small blind $0.01
DonRazVan18: posts big blind $0.02
*** HOLE CARDS ***
Dealt to HumptyD [Th Jd]
AT1LL4ZOREdd: folds
HumptyD: raises $0.04 to $0.06
LavrikSanta: folds
gamw_TROIKA: calls $0.06
priidikas1: folds
DonRazVan18: folds
*** FLOP *** [8s 4c 2c]
HumptyD: checks
gamw_TROIKA: checks
*** TURN *** [8s 4c 2c] [3d]
HumptyD: checks
gamw_TROIKA: checks
*** RIVER *** [8s 4c 2c 3d] [Tc]
HumptyD: checks
gamw_TROIKA: bets $0.18
HumptyD: calls $0.18
*** SHOW DOWN ***
gamw_TROIKA: shows [Qh Jh] (high card Queen)
HumptyD: shows [Th Jd] (a pair of Tens)
HumptyD collected $0.49 from pot
*** SUMMARY ***
Total pot $0.51 | Rake $0.02
Board [8s 4c 2c 3d Tc]
Seat 1: gamw_TROIKA (button) showed [Qh Jh] and lost with high card Queen
Seat 2: priidikas1 (small blind) folded before Flop
Seat 3: DonRazVan18 (big blind) folded before Flop
Seat 4: AT1LL4ZOREdd folded before Flop (didn't bet)
Seat 5: HumptyD showed [Th Jd] and won ($0.49) with a pair of Tens
Seat 6: LavrikSanta folded before Flop (didn't bet)

PokerStars Zoom Hand #251193632549:  Hold'em No Limit ($0.01/$0.02) - 2024/06/25 17:53:06 ET
Table 'Halley' 6-max Seat #1 is the button
Seat 1: flqcommander ($2.28 in chips)
Seat 2: HumptyD ($2.29 in chips)
Seat 3: GUILLE 1308 ($0.55 in chips)
Seat 4: gamw_TROIKA ($5.08 in chips)
Seat 5: hazedanger ($1.33 in chips)
Seat 6: viiv750 ($6.20 in chips)
HumptyD: posts small blind $0.01
GUILLE 1308: posts big blind $0.02
*** HOLE CARDS ***
Dealt to HumptyD [2d 7c]
gamw_TROIKA: raises $0.06 to $0.08
hazedanger: raises $0.21 to $0.29
viiv750: folds
flqcommander: folds
HumptyD: folds
GUILLE 1308: folds
gamw_TROIKA: calls $0.21
*** FLOP *** [3s 8c 5d]
gamw_TROIKA: checks
hazedanger: bets $0.59
gamw_TROIKA: raises $1.77 to $2.36
hazedanger: calls $0.45 and is all-in
Uncalled bet ($1.32) returned to gamw_TROIKA
*** TURN *** [3s 8c 5d] [5h]
*** RIVER *** [3s 8c 5d 5h] [6s]
*** SHOW DOWN ***
gamw_TROIKA: shows [Ah Kc] (a pair of Fives)
hazedanger: shows [Kd Kh] (two pair, Kings and Fives)
gamw_TROIKA cashed out the hand for $0.37 | Cash Out Fee $0.01
hazedanger cashed out the hand for $2.18 | Cash Out Fee $0.04
*** SUMMARY ***
Total pot $2.69 | Rake $0.09
Board [3s 8c 5d 5h 6s]
Seat 1: flqcommander (button) folded before Flop (didn't bet)
Seat 2: HumptyD (small blind) folded before Flop
Seat 3: GUILLE 1308 (big blind) folded before Flop
Seat 4: gamw_TROIKA showed [Ah Kc] and lost with a pair of Fives (cashed out).
Seat 5: hazedanger showed [Kd Kh] and won ($2.60) with two pair, Kings and Fives (pot not awarded as player cashed out)
Seat 6: viiv750 folded before Flop (didn't bet)

PokerStars Zoom Hand #251193634474:  Hold'em No Limit ($0.01/$0.02) - 2024/06/25 17:53:13 ET
Table 'Halley' 6-max Seat #1 is the button
Seat 1: NeoAsso ($2 in chips)
Seat 2: Jeandl0 ($8.26 in chips)
Seat 3: HumptyD ($2.28 in chips)
Seat 4: tolkien1986 ($3.11 in chips)
Seat 5: dundee is blue ($0.53 in chips)
Seat 6: maxteo15 ($5.56 in chips)
Jeandl0: posts small blind $0.01
HumptyD: posts big blind $0.02
*** HOLE CARDS ***
Dealt to HumptyD [Qh Ah]
tolkien1986 has timed out
tolkien1986: folds
dundee is blue: raises $0.51 to $0.53 and is all-in
maxteo15: folds
NeoAsso: folds
Jeandl0: folds
HumptyD: calls $0.51
*** FLOP *** [Js 6h Th]
*** TURN *** [Js 6h Th] [8s]
*** RIVER *** [Js 6h Th 8s] [2d]
*** SHOW DOWN ***
HumptyD: shows [Qh Ah] (high card Ace)
dundee is blue: shows [9s 9d] (a pair of Nines)
dundee is blue collected $1.03 from pot
*** SUMMARY ***
Total pot $1.07 | Rake $0.04
Board [Js 6h Th 8s 2d]
Seat 1: NeoAsso (button) folded before Flop (didn't bet)
Seat 2: Jeandl0 (small blind) folded before Flop
Seat 3: HumptyD (big blind) showed [Qh Ah] and lost with high card Ace
Seat 4: tolkien1986 folded before Flop (didn't bet)
Seat 5: dundee is blue showed [9s 9d] and won ($1.03) with a pair of Nines
Seat 6: maxteo15 folded before Flop (didn't bet)

PokerStars Zoom Hand #251193642916:  Hold'em No Limit ($0.01/$0.02) - 2024/06/25 17:53:44 ET
Table 'Halley' 6-max Seat #1 is the button
Seat 1: HumptyD ($2 in chips)
Seat 2: Her2827 ($3.86 in chips)
Seat 3: f12022 ($3.10 in chips)
Seat 4: Losimas(LT) ($2.46 in chips)
Seat 5: Luansspl ($2.86 in chips)
Seat 6: priidikas1 ($3.16 in chips)
Her2827: posts small blind $0.01
f12022: posts big blind $0.02
*** HOLE CARDS ***
Dealt to HumptyD [4h 3c]
Losimas(LT): folds
Luansspl: folds
priidikas1: folds
HumptyD: folds
Her2827: folds
Uncalled bet ($0.01) returned to f12022
f12022 collected $0.02 from pot
f12022: doesn't show hand
*** SUMMARY ***
Total pot $0.02 | Rake $0
Seat 1: HumptyD (button) folded before Flop (didn't bet)
Seat 2: Her2827 (small blind) folded before Flop
Seat 3: f12022 (big blind) collected ($0.02)
Seat 4: Losimas(LT) folded before Flop (didn't bet)
Seat 5: Luansspl folded before Flop (didn't bet)
Seat 6: priidikas1 folded before Flop (didn't bet)

PokerStars Zoom Hand #251193644556:  Hold'em No Limit ($0.01/$0.02) - 2024/06/25 17:53:50 ET
Table 'Halley' 6-max Seat #1 is the button
Seat 1: hazedanger ($2.18 in chips)
Seat 2: PepperEight ($1.47 in chips)
Seat 3: ARCUR1 ($4.36 in chips)
Seat 4: Alizle ($1.94 in chips)
Seat 5: JoeOfHearts ($2.07 in chips)
Seat 6: HumptyD ($2 in chips)
PepperEight: posts small blind $0.01
ARCUR1: posts big blind $0.02
*** HOLE CARDS ***
Dealt to HumptyD [8c 5h]
Alizle: folds
JoeOfHearts: folds
HumptyD: folds
hazedanger: raises $0.04 to $0.06
PepperEight: folds
ARCUR1: calls $0.04
*** FLOP *** [Ts 8d Qc]
ARCUR1: checks
hazedanger: checks
*** TURN *** [Ts 8d Qc] [2d]
ARCUR1: checks
hazedanger: checks
*** RIVER *** [Ts 8d Qc 2d] [5s]
ARCUR1: bets $0.04
hazedanger: calls $0.04
*** SHOW DOWN ***
ARCUR1: shows [7s 7c] (a pair of Sevens)
hazedanger: mucks hand
ARCUR1 collected $0.20 from pot
*** SUMMARY ***
Total pot $0.21 | Rake $0.01
Board [Ts 8d Qc 2d 5s]
Seat 1: hazedanger (button) mucked [As 2c]
Seat 2: PepperEight (small blind) folded before Flop
Seat 3: ARCUR1 (big blind) showed [7s 7c] and won ($0.20) with a pair of Sevens
Seat 4: Alizle folded before Flop (didn't bet)
Seat 5: JoeOfHearts folded before Flop (didn't bet)
Seat 6: HumptyD folded before Flop (didn't bet)

PokerStars Zoom Hand #251193647008:  Hold'em No Limit ($0.01/$0.02) - 2024/06/25 17:53:59 ET
Table 'Halley' 6-max Seat #1 is the button
Seat 1: TocaDoCoelho ($1.60 in chips)
Seat 2: M4DM4X_FR ($2.09 in chips)
Seat 3: Dizais27 ($2.51 in chips)
Seat 4: HumptyD ($2 in chips)
Seat 5: DonRazVan18 ($2.50 in chips)
Seat 6: ELJP ($2.37 in chips)
M4DM4X_FR: posts small blind $0.01
Dizais27: posts big blind $0.02
*** HOLE CARDS ***
Dealt to HumptyD [Qs Kc]
HumptyD: raises $0.04 to $0.06
DonRazVan18: folds
ELJP: folds
TocaDoCoelho: folds
M4DM4X_FR: folds
Dizais27: calls $0.04
*** FLOP *** [5s Td 6c]
Dizais27: checks
HumptyD: checks
*** TURN *** [5s Td 6c] [Ah]
Dizais27: bets $0.04
HumptyD: calls $0.04
*** RIVER *** [5s Td 6c Ah] [Tc]
Dizais27: bets $0.10
HumptyD: calls $0.10
*** SHOW DOWN ***
Dizais27: shows [As 9s] (two pair, Aces and Tens)
HumptyD: mucks hand
Dizais27 collected $0.40 from pot
*** SUMMARY ***
Total pot $0.41 | Rake $0.01
Board [5s Td 6c Ah Tc]
Seat 1: TocaDoCoelho (button) folded before Flop (didn't bet)
Seat 2: M4DM4X_FR (small blind) folded before Flop
Seat 3: Dizais27 (big blind) showed [As 9s] and won ($0.40) with two pair, Aces and Tens
Seat 4: HumptyD mucked [Qs Kc]
Seat 5: DonRazVan18 folded before Flop (didn't bet)
Seat 6: ELJP folded before Flop (didn't bet)

PokerStars Zoom Hand #251193661038:  Hold'em No Limit ($0.01/$0.02) - 2024/06/25 17:54:52 ET
Table 'Halley' 6-max Seat #1 is the button
Seat 1: LavrikSanta ($4.54 in chips)
Seat 2: HumptyD ($2 in chips)
Seat 3: Gaigel ($2.84 in chips)
Seat 4: NeoAsso ($2 in chips)
Seat 5: _Augustinho73 ($0.90 in chips)
Seat 6: paha1095 ($0.55 in chips)
HumptyD: posts small blind $0.01
Gaigel: posts big blind $0.02
*** HOLE CARDS ***
Dealt to HumptyD [3h Tc]
NeoAsso: folds
_Augustinho73: folds
paha1095: raises $0.04 to $0.06
LavrikSanta: folds
HumptyD: folds
Gaigel: folds
Uncalled bet ($0.04) returned to paha1095
paha1095 collected $0.05 from pot
paha1095: doesn't show hand
*** SUMMARY ***
Total pot $0.05 | Rake $0
Seat 1: LavrikSanta (button) folded before Flop (didn't bet)
Seat 2: HumptyD (small blind) folded before Flop
Seat 3: Gaigel (big blind) folded before Flop
Seat 4: NeoAsso folded before Flop (didn't bet)
Seat 5: _Augustinho73 folded before Flop (didn't bet)
Seat 6: paha1095 collected ($0.05)

PokerStars Zoom Hand #251193662368:  Hold'em No Limit ($0.01/$0.02) - 2024/06/25 17:54:56 ET
Table 'Halley' 6-max Seat #1 is the button
Seat 1: HumptyD ($2 in chips)
Seat 2: Probe_BeTT ($1.53 in chips)
Seat 3: JJcastk2 ($2.52 in chips)
Seat 4: _Augustinho73 ($0.90 in chips)
Seat 5: AT1LL4ZOREdd ($2.98 in chips)
Seat 6: Koresh153 ($1.04 in chips)
Probe_BeTT: posts small blind $0.01
JJcastk2: posts big blind $0.02
*** HOLE CARDS ***
Dealt to HumptyD [Qh Jd]
_Augustinho73: folds
AT1LL4ZOREdd: folds
Koresh153: folds
HumptyD: raises $0.04 to $0.06
Probe_BeTT: folds
JJcastk2: folds
Uncalled bet ($0.04) returned to HumptyD
HumptyD collected $0.05 from pot
HumptyD: doesn't show hand
*** SUMMARY ***
Total pot $0.05 | Rake $0
Seat 1: HumptyD (button) collected ($0.05)
Seat 2: Probe_BeTT (small blind) folded before Flop
Seat 3: JJcastk2 (big blind) folded before Flop
Seat 4: _Augustinho73 folded before Flop (didn't bet)
Seat 5: AT1LL4ZOREdd folded before Flop (didn't bet)
Seat 6: Koresh153 folded before Flop (didn't bet)

PokerStars Zoom Hand #251193666225:  Hold'em No Limit ($0.01/$0.02) - 2024/06/25 17:55:12 ET
Table 'Halley' 6-max Seat #1 is the button
Seat 1: sinster_ca85 ($2 in chips)
Seat 2: ranjete330 ($0.36 in chips)
Seat 3: amario89 ($2 in chips)
Seat 4: DonRazVan18 ($4.52 in chips)
Seat 5: julito39 ($2.02 in chips)
Seat 6: HumptyD ($2.03 in chips)
ranjete330: posts small blind $0.01
amario89: posts big blind $0.02
*** HOLE CARDS ***
Dealt to HumptyD [4s Ac]
DonRazVan18: folds
julito39: folds
HumptyD: folds
sinster_ca85: folds
ranjete330: folds
Uncalled bet ($0.01) returned to amario89
amario89 collected $0.02 from pot
amario89: doesn't show hand
*** SUMMARY ***
Total pot $0.02 | Rake $0
Seat 1: sinster_ca85 (button) folded before Flop (didn't bet)
Seat 2: ranjete330 (small blind) folded before Flop
Seat 3: amario89 (big blind) collected ($0.02)
Seat 4: DonRazVan18 folded before Flop (didn't bet)
Seat 5: julito39 folded before Flop (didn't bet)
Seat 6: HumptyD folded before Flop (didn't bet)

PokerStars Zoom Hand #251193674737:  Hold'em No Limit ($0.01/$0.02) - 2024/06/25 17:55:54 ET
Table 'Halley' 6-max Seat #1 is the button
Seat 1: ricardostorres ($0.80 in chips)
Seat 2: julito39 ($2.33 in chips)
Seat 3: TSCardinals ($2.19 in chips)
Seat 4: M4DM4X_FR ($2.07 in chips)
Seat 5: HumptyD ($2.01 in chips)
Seat 6: gamw_TROIKA ($4.47 in chips)
julito39: posts small blind $0.01
TSCardinals: posts big blind $0.02
*** HOLE CARDS ***
Dealt to HumptyD [2d Jd]
M4DM4X_FR: raises $0.02 to $0.04
HumptyD: folds
gamw_TROIKA: folds
ricardostorres: folds
julito39: folds
TSCardinals: folds
Uncalled bet ($0.02) returned to M4DM4X_FR
M4DM4X_FR collected $0.05 from pot
M4DM4X_FR: doesn't show hand
*** SUMMARY ***
Total pot $0.05 | Rake $0
Seat 1: ricardostorres (button) folded before Flop (didn't bet)
Seat 2: julito39 (small blind) folded before Flop
Seat 3: TSCardinals (big blind) folded before Flop
Seat 4: M4DM4X_FR collected ($0.05)
Seat 5: HumptyD folded before Flop (didn't bet)
Seat 6: gamw_TROIKA folded before Flop (didn't bet)

PokerStars Zoom Hand #251193667917:  Hold'em No Limit ($0.01/$0.02) - 2024/06/25 17:55:20 ET
Table 'Halley' 6-max Seat #1 is the button
Seat 1: DonRazVan18 ($2.63 in chips)
Seat 2: LustaKandur ($2.62 in chips)
Seat 3: dundee is blue ($1.98 in chips)
Seat 4: cod4x ($3.66 in chips)
Seat 5: HumptyD ($2.03 in chips)
Seat 6: Gaigel ($3.16 in chips)
LustaKandur: posts small blind $0.01
dundee is blue: posts big blind $0.02
*** HOLE CARDS ***
Dealt to HumptyD [5h Qd]
cod4x: raises $0.02 to $0.04
HumptyD: folds
Gaigel: calls $0.04
DonRazVan18: folds
LustaKandur: calls $0.03
dundee is blue: folds
*** FLOP *** [Qh 8s 2s]
LustaKandur: checks
cod4x: checks
Gaigel: bets $0.07
LustaKandur: calls $0.07
cod4x: folds
*** TURN *** [Qh 8s 2s] [3d]
LustaKandur: checks
Gaigel: checks
*** RIVER *** [Qh 8s 2s 3d] [Kh]
LustaKandur: checks
Gaigel: checks
*** SHOW DOWN ***
LustaKandur: shows [9c Th] (high card King)
Gaigel: shows [Jc Ah] (high card Ace)
Gaigel collected $0.27 from pot
*** SUMMARY ***
Total pot $0.28 | Rake $0.01
Board [Qh 8s 2s 3d Kh]
Seat 1: DonRazVan18 (button) folded before Flop (didn't bet)
Seat 2: LustaKandur (small blind) showed [9c Th] and lost with high card King
Seat 3: dundee is blue (big blind) folded before Flop
Seat 4: cod4x folded on the Flop
Seat 5: HumptyD folded before Flop (didn't bet)
Seat 6: Gaigel showed [Jc Ah] and won ($0.27) with high card Ace

PokerStars Zoom Hand #251193670424:  Hold'em No Limit ($0.01/$0.02) - 2024/06/25 17:55:32 ET
Table 'Halley' 6-max Seat #1 is the button
Seat 1: Dizais27 ($2.81 in chips)
Seat 2: djulio94rike ($2.11 in chips)
Seat 3: HumptyD ($2.03 in chips)
Seat 4: Koresh153 ($1.03 in chips)
Seat 5: tolkien1986 ($2.39 in chips)
Seat 6: mistershahuk ($4.83 in chips)
djulio94rike: posts small blind $0.01
HumptyD: posts big blind $0.02
*** HOLE CARDS ***
Dealt to HumptyD [Qc 3h]
Koresh153: folds
tolkien1986: folds
mistershahuk: raises $0.02 to $0.04
Dizais27: calls $0.04
djulio94rike: folds
HumptyD: folds
*** FLOP *** [6d 5s 9c]
mistershahuk: checks
Dizais27: bets $0.02
mistershahuk: calls $0.02
*** TURN *** [6d 5s 9c] [2h]
mistershahuk: checks
Dizais27: bets $0.06
mistershahuk: calls $0.06
*** RIVER *** [6d 5s 9c 2h] [Ac]
mistershahuk: checks
Dizais27: bets $0.13
mistershahuk: raises $0.13 to $0.26
Dizais27: folds
Uncalled bet ($0.13) returned to mistershahuk
mistershahuk collected $0.51 from pot
mistershahuk: doesn't show hand
*** SUMMARY ***
Total pot $0.53 | Rake $0.02
Board [6d 5s 9c 2h Ac]
Seat 1: Dizais27 (button) folded on the River
Seat 2: djulio94rike (small blind) folded before Flop
Seat 3: HumptyD (big blind) folded before Flop
Seat 4: Koresh153 folded before Flop (didn't bet)
Seat 5: tolkien1986 folded before Flop (didn't bet)
Seat 6: mistershahuk collected ($0.51)

PokerStars Zoom Hand #251193676991:  Hold'em No Limit ($0.01/$0.02) - 2024/06/25 17:56:04 ET
Table 'Halley' 6-max Seat #1 is the button
Seat 1: Money4meBr ($1.27 in chips)
Seat 2: gasmar_29 ($2.26 in chips)
Seat 3: Cowden Calling ($3.45 in chips)
Seat 4: pATU8D ($3.77 in chips)
Seat 5: TSCardinals ($2.17 in chips)
Seat 6: HumptyD ($2.01 in chips)
gasmar_29: posts small blind $0.01
Cowden Calling: posts big blind $0.02
*** HOLE CARDS ***
Dealt to HumptyD [2c Th]
pATU8D: folds
TSCardinals: folds
HumptyD: folds
Money4meBr: raises $0.03 to $0.05
gasmar_29: calls $0.04
Cowden Calling: calls $0.03
*** FLOP *** [Kd Tc 6d]
gasmar_29: bets $0.07
Cowden Calling: folds
Money4meBr: folds
Uncalled bet ($0.07) returned to gasmar_29
gasmar_29 collected $0.14 from pot
gasmar_29: doesn't show hand
*** SUMMARY ***
Total pot $0.15 | Rake $0.01
Board [Kd Tc 6d]
Seat 1: Money4meBr (button) folded on the Flop
Seat 2: gasmar_29 (small blind) collected ($0.14)
Seat 3: Cowden Calling (big blind) folded on the Flop
Seat 4: pATU8D folded before Flop (didn't bet)
Seat 5: TSCardinals folded before Flop (didn't bet)
Seat 6: HumptyD folded before Flop (didn't bet)

PokerStars Zoom Hand #251193676173:  Hold'em No Limit ($0.01/$0.02) - 2024/06/25 17:56:00 ET
Table 'Halley' 6-max Seat #1 is the button
Seat 1: Jeandl0 ($4.16 in chips)
Seat 2: ELJP ($2.34 in chips)
Seat 3: fugadeluz ($5.88 in chips)
Seat 4: HumptyD ($2.01 in chips)
Seat 5: Bmillz11 ($2.30 in chips)
Seat 6: Money4meBr ($1.86 in chips)
ELJP: posts small blind $0.01
fugadeluz: posts big blind $0.02
*** HOLE CARDS ***
Dealt to HumptyD [Kc 8h]
HumptyD: folds
Bmillz11: raises $0.03 to $0.05
Money4meBr: folds
Jeandl0: folds
ELJP: calls $0.04
fugadeluz: calls $0.03
*** FLOP *** [2c Th 7d]
ELJP: checks
fugadeluz: checks
Bmillz11: bets $0.06
ELJP: folds
fugadeluz: folds
Uncalled bet ($0.06) returned to Bmillz11
Bmillz11 collected $0.14 from pot
Bmillz11: doesn't show hand
*** SUMMARY ***
Total pot $0.15 | Rake $0.01
Board [2c Th 7d]
Seat 1: Jeandl0 (button) folded before Flop (didn't bet)
Seat 2: ELJP (small blind) folded on the Flop
Seat 3: fugadeluz (big blind) folded on the Flop
Seat 4: HumptyD folded before Flop (didn't bet)
Seat 5: Bmillz11 collected ($0.14)
Seat 6: Money4meBr folded before Flop (didn't bet)

PokerStars Zoom Hand #251193679597:  Hold'em No Limit ($0.01/$0.02) - 2024/06/25 17:56:16 ET
Table 'Halley' 6-max Seat #1 is the button
Seat 1: Nomi Kopi ($1.79 in chips)
Seat 2: HumptyD ($2.01 in chips)
Seat 3: pATU8D ($3.77 in chips)
Seat 4: mianduar280216 ($3.22 in chips)
Seat 5: sinster_ca85 ($2.18 in chips)
Seat 6: DONITA60 ($5.16 in chips)
HumptyD: posts small blind $0.01
pATU8D: posts big blind $0.02
*** HOLE CARDS ***
Dealt to HumptyD [Qd 2d]
mianduar280216: folds
sinster_ca85: folds
DONITA60: folds
Nomi Kopi: folds
HumptyD: raises $0.04 to $0.06
pATU8D: calls $0.04
*** FLOP *** [3h Jh 6c]
HumptyD: checks
pATU8D: checks
*** TURN *** [3h Jh 6c] [Jc]
HumptyD: checks
pATU8D: checks
*** RIVER *** [3h Jh 6c Jc] [Kd]
HumptyD: checks
pATU8D: bets $0.09
HumptyD: folds
Uncalled bet ($0.09) returned to pATU8D
pATU8D collected $0.12 from pot
pATU8D: doesn't show hand
*** SUMMARY ***
Total pot $0.12 | Rake $0
Board [3h Jh 6c Jc Kd]
Seat 1: Nomi Kopi (button) folded before Flop (didn't bet)
Seat 2: HumptyD (small blind) folded on the River
Seat 3: pATU8D (big blind) collected ($0.12)
Seat 4: mianduar280216 folded before Flop (didn't bet)
Seat 5: sinster_ca85 folded before Flop (didn't bet)
Seat 6: DONITA60 folded before Flop (didn't bet)

PokerStars Zoom Hand #251193694034:  Hold'em No Limit ($0.01/$0.02) - 2024/06/25 17:57:25 ET
Table 'Halley' 6-max Seat #1 is the button
Seat 1: sinster_ca85 ($2.25 in chips)
Seat 2: Her2827 ($4.59 in chips)
Seat 3: MrRooob9899 ($2.08 in chips)
Seat 4: HumptyD ($2 in chips)
Seat 5: Tricolor1980 ($1.82 in chips)
Seat 6: _Augustinho73 ($0.74 in chips)
Her2827: posts small blind $0.01
MrRooob9899: posts big blind $0.02
*** HOLE CARDS ***
Dealt to HumptyD [5d Qh]
HumptyD: folds
Tricolor1980: folds
_Augustinho73: raises $0.03 to $0.05
sinster_ca85: folds
Her2827: folds
MrRooob9899: calls $0.03
*** FLOP *** [4c Ks 3h]
MrRooob9899: checks
_Augustinho73: bets $0.03
MrRooob9899: calls $0.03
*** TURN *** [4c Ks 3h] [5h]
MrRooob9899: checks
_Augustinho73: bets $0.05
MrRooob9899: folds
Uncalled bet ($0.05) returned to _Augustinho73
_Augustinho73 collected $0.16 from pot
_Augustinho73: doesn't show hand
*** SUMMARY ***
Total pot $0.17 | Rake $0.01
Board [4c Ks 3h 5h]
Seat 1: sinster_ca85 (button) folded before Flop (didn't bet)
Seat 2: Her2827 (small blind) folded before Flop
Seat 3: MrRooob9899 (big blind) folded on the Turn
Seat 4: HumptyD folded before Flop (didn't bet)
Seat 5: Tricolor1980 folded before Flop (didn't bet)
Seat 6: _Augustinho73 collected ($0.16)

PokerStars Zoom Hand #251193692567:  Hold'em No Limit ($0.01/$0.02) - 2024/06/25 17:57:19 ET
Table 'Halley' 6-max Seat #1 is the button
Seat 1: HumptyD ($2 in chips)
Seat 2: tibcsi9999 ($1.84 in chips)
Seat 3: cod4x ($2.39 in chips)
Seat 4: Her2827 ($4.07 in chips)
Seat 5: Odds76 ($1.70 in chips)
Seat 6: maldobex ($2.14 in chips)
tibcsi9999: posts small blind $0.01
cod4x: posts big blind $0.02
*** HOLE CARDS ***
Dealt to HumptyD [8h 3c]
Her2827: folds
Odds76: folds
maldobex: raises $0.03 to $0.05
HumptyD: folds
tibcsi9999: folds
cod4x: calls $0.03
*** FLOP *** [2d Jh 8s]
cod4x: bets $0.11
maldobex: folds
Uncalled bet ($0.11) returned to cod4x
cod4x collected $0.11 from pot
cod4x: doesn't show hand
*** SUMMARY ***
Total pot $0.11 | Rake $0
Board [2d Jh 8s]
Seat 1: HumptyD (button) folded before Flop (didn't bet)
Seat 2: tibcsi9999 (small blind) folded before Flop
Seat 3: cod4x (big blind) collected ($0.11)
Seat 4: Her2827 folded before Flop (didn't bet)
Seat 5: Odds76 folded before Flop (didn't bet)
Seat 6: maldobex folded on the Flop

PokerStars Zoom Hand #251193695043:  Hold'em No Limit ($0.01/$0.02) - 2024/06/25 17:57:31 ET
Table 'Halley' 6-max Seat #1 is the button
Seat 1: tolkien1986 ($2.09 in chips)
Seat 2: AT1LL4ZOREdd ($2.49 in chips)
Seat 3: HumptyD ($2 in chips)
Seat 4: f12022 ($3.15 in chips)
Seat 5: adymarduk ($2.02 in chips)
Seat 6: gasmar_29 ($2 in chips)
AT1LL4ZOREdd: posts small blind $0.01
HumptyD: posts big blind $0.02
*** HOLE CARDS ***
Dealt to HumptyD [Kd Js]
f12022: folds
adymarduk: folds
gasmar_29: folds
tolkien1986: folds
AT1LL4ZOREdd: raises $0.04 to $0.06
HumptyD: calls $0.04
*** FLOP *** [Tc 6d 3c]
AT1LL4ZOREdd: bets $0.06
HumptyD: folds
Uncalled bet ($0.06) returned to AT1LL4ZOREdd
AT1LL4ZOREdd collected $0.12 from pot
AT1LL4ZOREdd: doesn't show hand
*** SUMMARY ***
Total pot $0.12 | Rake $0
Board [Tc 6d 3c]
Seat 1: tolkien1986 (button) folded before Flop (didn't bet)
Seat 2: AT1LL4ZOREdd (small blind) collected ($0.12)
Seat 3: HumptyD (big blind) folded on the Flop
Seat 4: f12022 folded before Flop (didn't bet)
Seat 5: adymarduk folded before Flop (didn't bet)
Seat 6: gasmar_29 folded before Flop (didn't bet)

PokerStars Zoom Hand #251193702692:  Hold'em No Limit ($0.01/$0.02) - 2024/06/25 17:58:07 ET
Table 'Halley' 6-max Seat #1 is the button
Seat 1: YiannisKar ($2.15 in chips)
Seat 2: HumptyD ($2 in chips)
Seat 3: darriox ($1.84 in chips)
Seat 4: Odds76 ($1.73 in chips)
Seat 5: Cowden Calling ($3.68 in chips)
Seat 6: f12022 ($2.07 in chips)
HumptyD: posts small blind $0.01
darriox: posts big blind $0.02
*** HOLE CARDS ***
Dealt to HumptyD [Qd 3c]
Odds76: folds
Cowden Calling: folds
f12022: raises $0.04 to $0.06
YiannisKar: folds
HumptyD: folds
darriox: folds
Uncalled bet ($0.04) returned to f12022
f12022 collected $0.05 from pot
f12022: doesn't show hand
*** SUMMARY ***
Total pot $0.05 | Rake $0
Seat 1: YiannisKar (button) folded before Flop (didn't bet)
Seat 2: HumptyD (small blind) folded before Flop
Seat 3: darriox (big blind) folded before Flop
Seat 4: Odds76 folded before Flop (didn't bet)
Seat 5: Cowden Calling folded before Flop (didn't bet)
Seat 6: f12022 collected ($0.05)

PokerStars Zoom Hand #251193701630:  Hold'em No Limit ($0.01/$0.02) - 2024/06/25 17:58:02 ET
Table 'Halley' 6-max Seat #1 is the button
Seat 1: MrRooob9899 ($1.99 in chips)
Seat 2: tolkien1986 ($2.07 in chips)
Seat 3: Nomi Kopi ($1.45 in chips)
Seat 4: josesde ($2.09 in chips)
Seat 5: HumptyD ($2 in chips)
Seat 6: gasmar_29 ($2.02 in chips)
tolkien1986: posts small blind $0.01
Nomi Kopi: posts big blind $0.02
*** HOLE CARDS ***
Dealt to HumptyD [6d 4c]
josesde: calls $0.02
HumptyD: folds
gasmar_29: folds
MrRooob9899: folds
tolkien1986: folds
Nomi Kopi: checks
*** FLOP *** [7d 8s Qd]
Nomi Kopi: checks
josesde: bets $0.06
Nomi Kopi: folds
Uncalled bet ($0.06) returned to josesde
josesde collected $0.05 from pot
josesde: doesn't show hand
*** SUMMARY ***
Total pot $0.05 | Rake $0
Board [7d 8s Qd]
Seat 1: MrRooob9899 (button) folded before Flop (didn't bet)
Seat 2: tolkien1986 (small blind) folded before Flop
Seat 3: Nomi Kopi (big blind) folded on the Flop
Seat 4: josesde collected ($0.05)
Seat 5: HumptyD folded before Flop (didn't bet)
Seat 6: gasmar_29 folded before Flop (didn't bet)

PokerStars Zoom Hand #251193704557:  Hold'em No Limit ($0.01/$0.02) - 2024/06/25 17:58:16 ET
Table 'Halley' 6-max Seat #1 is the button
Seat 1: Fox00777 ($1.87 in chips)
Seat 2: Bmillz11 ($2.48 in chips)
Seat 3: cod4x ($2.76 in chips)
Seat 4: sinster_ca85 ($2 in chips)
Seat 5: Ryphor ($2.30 in chips)
Seat 6: HumptyD ($2 in chips)
Bmillz11: posts small blind $0.01
cod4x: posts big blind $0.02
*** HOLE CARDS ***
Dealt to HumptyD [9c 5d]
sinster_ca85: folds
Ryphor: raises $0.02 to $0.04
HumptyD: folds
Fox00777: folds
Bmillz11: folds
cod4x: calls $0.02
*** FLOP *** [7d Td Qh]
cod4x: checks
Ryphor: bets $0.04
cod4x: folds
Uncalled bet ($0.04) returned to Ryphor
Ryphor collected $0.09 from pot
Ryphor: doesn't show hand
*** SUMMARY ***
Total pot $0.09 | Rake $0
Board [7d Td Qh]
Seat 1: Fox00777 (button) folded before Flop (didn't bet)
Seat 2: Bmillz11 (small blind) folded before Flop
Seat 3: cod4x (big blind) folded on the Flop
Seat 4: sinster_ca85 folded before Flop (didn't bet)
Seat 5: Ryphor collected ($0.09)
Seat 6: HumptyD folded before Flop (didn't bet)

PokerStars Zoom Hand #251193705584:  Hold'em No Limit ($0.01/$0.02) - 2024/06/25 17:58:21 ET
Table 'Halley' 6-max Seat #1 is the button
Seat 1: HumptyD ($2 in chips)
Seat 2: Overcoystream ($2.13 in chips)
Seat 3: giovane787 ($2 in chips)
Seat 4: LustaKandur ($2 in chips)
Seat 5: LavrikSanta ($2 in chips)
Seat 6: S-SKlP ($1.66 in chips)
Overcoystream: posts small blind $0.01
giovane787: posts big blind $0.02
*** HOLE CARDS ***
Dealt to HumptyD [Qs 8s]
LustaKandur: folds
LavrikSanta: folds
S-SKlP: raises $0.02 to $0.04
HumptyD: calls $0.04
Overcoystream: folds
giovane787: calls $0.02
*** FLOP *** [Qc Kh Jd]
giovane787: checks
S-SKlP: checks
HumptyD: checks
*** TURN *** [Qc Kh Jd] [Qd]
giovane787: checks
S-SKlP: checks
HumptyD: bets $0.10
giovane787: calls $0.10
S-SKlP: folds
*** RIVER *** [Qc Kh Jd Qd] [3d]
giovane787: checks
HumptyD: checks
*** SHOW DOWN ***
giovane787: shows [Kd 8h] (two pair, Kings and Queens)
HumptyD: shows [Qs 8s] (three of a kind, Queens)
HumptyD collected $0.32 from pot
*** SUMMARY ***
Total pot $0.33 | Rake $0.01
Board [Qc Kh Jd Qd 3d]
Seat 1: HumptyD (button) showed [Qs 8s] and won ($0.32) with three of a kind, Queens
Seat 2: Overcoystream (small blind) folded before Flop
Seat 3: giovane787 (big blind) showed [Kd 8h] and lost with two pair, Kings and Queens
Seat 4: LustaKandur folded before Flop (didn't bet)
Seat 5: LavrikSanta folded before Flop (didn't bet)
Seat 6: S-SKlP folded on the Turn

PokerStars Zoom Hand #251193717703:  Hold'em No Limit ($0.01/$0.02) - 2024/06/25 17:59:18 ET
Table 'Halley' 6-max Seat #1 is the button
Seat 1: Overcoystream ($2.20 in chips)
Seat 2: lottokahe2 ($3.78 in chips)
Seat 3: rico_barriga ($1.81 in chips)
Seat 4: HumptyD ($2.18 in chips)
Seat 5: LustaKandur ($2.80 in chips)
Seat 6: jaldini ($1.86 in chips)
lottokahe2: posts small blind $0.01
rico_barriga: posts big blind $0.02
*** HOLE CARDS ***
Dealt to HumptyD [2c 3s]
HumptyD: folds
LustaKandur: folds
jaldini: folds
Overcoystream: folds
lottokahe2: folds
Uncalled bet ($0.01) returned to rico_barriga
rico_barriga collected $0.02 from pot
rico_barriga: doesn't show hand
*** SUMMARY ***
Total pot $0.02 | Rake $0
Seat 1: Overcoystream (button) folded before Flop (didn't bet)
Seat 2: lottokahe2 (small blind) folded before Flop
Seat 3: rico_barriga (big blind) collected ($0.02)
Seat 4: HumptyD folded before Flop (didn't bet)
Seat 5: LustaKandur folded before Flop (didn't bet)
Seat 6: jaldini folded before Flop (didn't bet)

PokerStars Zoom Hand #251193716825:  Hold'em No Limit ($0.01/$0.02) - 2024/06/25 17:59:14 ET
Table 'Halley' 6-max Seat #1 is the button
Seat 1: jaldini ($2.71 in chips)
Seat 2: giovane787 ($2 in chips)
Seat 3: NeoAsso ($3.64 in chips)
Seat 4: HumptyD ($2.18 in chips)
Seat 5: Cowden Calling ($2.91 in chips)
Seat 6: superdepart ($3.05 in chips)
giovane787: posts small blind $0.01
NeoAsso: posts big blind $0.02
*** HOLE CARDS ***
Dealt to HumptyD [5h Kd]
HumptyD: folds
Cowden Calling: raises $0.02 to $0.04
superdepart: calls $0.04
jaldini: folds
giovane787: raises $0.16 to $0.20
NeoAsso: folds
Cowden Calling: calls $0.16
superdepart: calls $0.16
*** FLOP *** [4d 6d Ad]
giovane787: bets $0.42
Cowden Calling: folds
superdepart: folds
Uncalled bet ($0.42) returned to giovane787
giovane787 collected $0.60 from pot
giovane787: doesn't show hand
*** SUMMARY ***
Total pot $0.62 | Rake $0.02
Board [4d 6d Ad]
Seat 1: jaldini (button) folded before Flop (didn't bet)
Seat 2: giovane787 (small blind) collected ($0.60)
Seat 3: NeoAsso (big blind) folded before Flop
Seat 4: HumptyD folded before Flop (didn't bet)
Seat 5: Cowden Calling folded on the Flop
Seat 6: superdepart folded on the Flop

PokerStars Zoom Hand #251193718579:  Hold'em No Limit ($0.01/$0.02) - 2024/06/25 17:59:22 ET
Table 'Halley' 6-max Seat #1 is the button
Seat 1: migbot ($2.28 in chips)
Seat 2: Reillyo123 ($2.19 in chips)
Seat 3: HumptyD ($2.18 in chips)
Seat 4: _Augustinho73 ($0.89 in chips)
Seat 5: Jeandl0 ($8.34 in chips)
Seat 6: Amazonia2010 ($2.17 in chips)
Reillyo123: posts small blind $0.01
HumptyD: posts big blind $0.02
*** HOLE CARDS ***
Dealt to HumptyD [Ah Qs]
_Augustinho73: folds
Jeandl0: folds
Amazonia2010: folds
migbot: calls $0.02
Reillyo123: folds
HumptyD: checks
*** FLOP *** [Jd 2s 9c]
HumptyD: checks
migbot: checks
*** TURN *** [Jd 2s 9c] [5d]
HumptyD: checks
migbot: checks
*** RIVER *** [Jd 2s 9c 5d] [8h]
HumptyD: checks
migbot: checks
*** SHOW DOWN ***
HumptyD: shows [Ah Qs] (high card Ace)
migbot: mucks hand
HumptyD collected $0.05 from pot
*** SUMMARY ***
Total pot $0.05 | Rake $0
Board [Jd 2s 9c 5d 8h]
Seat 1: migbot (button) mucked [4c Tc]
Seat 2: Reillyo123 (small blind) folded before Flop
Seat 3: HumptyD (big blind) showed [Ah Qs] and won ($0.05) with high card Ace
Seat 4: _Augustinho73 folded before Flop (didn't bet)
Seat 5: Jeandl0 folded before Flop (didn't bet)
Seat 6: Amazonia2010 folded before Flop (didn't bet)

PokerStars Zoom Hand #251193733183:  Hold'em No Limit ($0.01/$0.02) - 2024/06/25 18:00:31 ET
Table 'Halley' 6-max Seat #1 is the button
Seat 1: jaldini ($1.85 in chips)
Seat 2: HumptyD ($2.21 in chips)
Seat 3: Tricolor1980 ($1.19 in chips)
Seat 4: Jeandl0 ($4.37 in chips)
Seat 5: mr.Lugaro ($2.84 in chips)
Seat 6: M4DM4X_FR ($2.26 in chips)
HumptyD: posts small blind $0.01
Tricolor1980: posts big blind $0.02
*** HOLE CARDS ***
Dealt to HumptyD [Jd Ad]
Jeandl0: folds
mr.Lugaro: folds
M4DM4X_FR: raises $0.02 to $0.04
jaldini: raises $0.09 to $0.13
HumptyD: folds
Tricolor1980: folds
M4DM4X_FR: folds
Uncalled bet ($0.09) returned to jaldini
jaldini collected $0.11 from pot
jaldini: doesn't show hand
*** SUMMARY ***
Total pot $0.11 | Rake $0
Seat 1: jaldini (button) collected ($0.11)
Seat 2: HumptyD (small blind) folded before Flop
Seat 3: Tricolor1980 (big blind) folded before Flop
Seat 4: Jeandl0 folded before Flop (didn't bet)
Seat 5: mr.Lugaro folded before Flop (didn't bet)
Seat 6: M4DM4X_FR folded before Flop

PokerStars Zoom Hand #251193737566:  Hold'em No Limit ($0.01/$0.02) - 2024/06/25 18:00:50 ET
Table 'Halley' 6-max Seat #1 is the button
Seat 1: HumptyD ($2.20 in chips)
Seat 2: JahromeT ($3.86 in chips)
Seat 3: Amazonia2010 ($2.33 in chips)
Seat 4: tolkien1986 ($2 in chips)
Seat 5: LustaKandur ($2.77 in chips)
Seat 6: DONITA60 ($5.55 in chips)
JahromeT: posts small blind $0.01
Amazonia2010: posts big blind $0.02
*** HOLE CARDS ***
Dealt to HumptyD [3c 2c]
tolkien1986: folds
LustaKandur: folds
DONITA60: folds
HumptyD: folds
JahromeT: raises $0.04 to $0.06
Amazonia2010: calls $0.04
*** FLOP *** [Kc Kd Ah]
JahromeT: checks
Amazonia2010: checks
*** TURN *** [Kc Kd Ah] [4s]
JahromeT: bets $0.06
Amazonia2010: calls $0.06
*** RIVER *** [Kc Kd Ah 4s] [6d]
JahromeT: bets $0.12
Amazonia2010: calls $0.12
*** SHOW DOWN ***
JahromeT: shows [Kh Th] (three of a kind, Kings)
Amazonia2010: mucks hand
JahromeT collected $0.46 from pot
*** SUMMARY ***
Total pot $0.48 | Rake $0.02
Board [Kc Kd Ah 4s 6d]
Seat 1: HumptyD (button) folded before Flop (didn't bet)
Seat 2: JahromeT (small blind) showed [Kh Th] and won ($0.46) with three of a kind, Kings
Seat 3: Amazonia2010 (big blind) mucked [4d As]
Seat 4: tolkien1986 folded before Flop (didn't bet)
Seat 5: LustaKandur folded before Flop (didn't bet)
Seat 6: DONITA60 folded before Flop (didn't bet)

PokerStars Zoom Hand #251193736356:  Hold'em No Limit ($0.01/$0.02) - 2024/06/25 18:00:45 ET
Table 'Halley' 6-max Seat #1 is the button
Seat 1: gasmar_29 ($2.26 in chips)
Seat 2: TSCardinals ($2.30 in chips)
Seat 3: sound_only ($2 in chips)
Seat 4: HumptyD ($2.20 in chips)
Seat 5: amario89 ($2.04 in chips)
Seat 6: ferx1989 ($4.28 in chips)
TSCardinals: posts small blind $0.01
sound_only: posts big blind $0.02
*** HOLE CARDS ***
Dealt to HumptyD [8s 2s]
HumptyD: folds
amario89: folds
ferx1989: raises $0.03 to $0.05
gasmar_29: folds
TSCardinals: raises $0.43 to $0.48
sound_only: folds
ferx1989: folds
Uncalled bet ($0.43) returned to TSCardinals
TSCardinals collected $0.12 from pot
TSCardinals: doesn't show hand
*** SUMMARY ***
Total pot $0.12 | Rake $0
Seat 1: gasmar_29 (button) folded before Flop (didn't bet)
Seat 2: TSCardinals (small blind) collected ($0.12)
Seat 3: sound_only (big blind) folded before Flop
Seat 4: HumptyD folded before Flop (didn't bet)
Seat 5: amario89 folded before Flop (didn't bet)
Seat 6: ferx1989 folded before Flop

PokerStars Zoom Hand #251193738801:  Hold'em No Limit ($0.01/$0.02) - 2024/06/25 18:00:55 ET
Table 'Halley' 6-max Seat #1 is the button
Seat 1: tolkien1986 ($2 in chips)
Seat 2: Karfmad ($2.56 in chips)
Seat 3: HumptyD ($2.20 in chips)
Seat 4: Sumpfpumpf ($2.29 in chips)
Seat 5: Ryosuke913 ($2.01 in chips)
Seat 6: ELJP ($2.73 in chips)
Karfmad: posts small blind $0.01
HumptyD: posts big blind $0.02
*** HOLE CARDS ***
Dealt to HumptyD [Jc Jd]
Sumpfpumpf: folds
Ryosuke913: folds
ELJP: folds
tolkien1986: folds
Karfmad: raises $0.02 to $0.04
HumptyD: raises $0.08 to $0.12
Karfmad: calls $0.08
*** FLOP *** [9d 2d Jh]
Karfmad: checks
HumptyD: bets $0.23
Karfmad: folds
Uncalled bet ($0.23) returned to HumptyD
HumptyD collected $0.23 from pot
HumptyD: doesn't show hand
*** SUMMARY ***
Total pot $0.24 | Rake $0.01
Board [9d 2d Jh]
Seat 1: tolkien1986 (button) folded before Flop (didn't bet)
Seat 2: Karfmad (small blind) folded on the Flop
Seat 3: HumptyD (big blind) collected ($0.23)
Seat 4: Sumpfpumpf folded before Flop (didn't bet)
Seat 5: Ryosuke913 folded before Flop (didn't bet)
Seat 6: ELJP folded before Flop (didn't bet)

PokerStars Zoom Hand #251193747503:  Hold'em No Limit ($0.01/$0.02) - 2024/06/25 18:01:31 ET
Table 'Halley' 6-max Seat #1 is the button
Seat 1: priidikas1 ($1.78 in chips)
Seat 2: Kasper1906 ($0.43 in chips)
Seat 3: gasmar_29 ($2 in chips)
Seat 4: Rasack007 ($2.18 in chips)
Seat 5: Gambit1526 ($2 in chips)
Seat 6: HumptyD ($2.31 in chips)
Kasper1906: posts small blind $0.01
gasmar_29: posts big blind $0.02
*** HOLE CARDS ***
Dealt to HumptyD [2s 8h]
Rasack007: folds
Gambit1526: folds
HumptyD: folds
priidikas1: raises $0.05 to $0.07
Kasper1906: calls $0.06
gasmar_29: folds
*** FLOP *** [5d Th 2c]
Kasper1906: checks
priidikas1: checks
*** TURN *** [5d Th 2c] [Qs]
Kasper1906: checks
priidikas1: checks
*** RIVER *** [5d Th 2c Qs] [As]
Kasper1906: bets $0.08
priidikas1: folds
Uncalled bet ($0.08) returned to Kasper1906
Kasper1906 collected $0.15 from pot
Kasper1906: doesn't show hand
*** SUMMARY ***
Total pot $0.16 | Rake $0.01
Board [5d Th 2c Qs As]
Seat 1: priidikas1 (button) folded on the River
Seat 2: Kasper1906 (small blind) collected ($0.15)
Seat 3: gasmar_29 (big blind) folded before Flop
Seat 4: Rasack007 folded before Flop (didn't bet)
Seat 5: Gambit1526 folded before Flop (didn't bet)
Seat 6: HumptyD folded before Flop (didn't bet)

PokerStars Zoom Hand #251193748437:  Hold'em No Limit ($0.01/$0.02) - 2024/06/25 18:01:35 ET
Table 'Halley' 6-max Seat #1 is the button
Seat 1: Sumpfpumpf ($2.44 in chips)
Seat 2: JFray756 ($1.77 in chips)
Seat 3: mr.Lugaro ($3.80 in chips)
Seat 4: LavrikSanta ($2 in chips)
Seat 5: HumptyD ($2.31 in chips)
Seat 6: Probe_BeTT ($1.62 in chips)
JFray756: posts small blind $0.01
mr.Lugaro: posts big blind $0.02
*** HOLE CARDS ***
Dealt to HumptyD [8c 5h]
LavrikSanta: folds
HumptyD: folds
Probe_BeTT: folds
Sumpfpumpf: raises $0.04 to $0.06
JFray756: folds
mr.Lugaro: calls $0.04
*** FLOP *** [Kc 6h Ac]
mr.Lugaro: checks
Sumpfpumpf: bets $0.08
mr.Lugaro: calls $0.08
*** TURN *** [Kc 6h Ac] [7c]
mr.Lugaro: checks
Sumpfpumpf: checks
*** RIVER *** [Kc 6h Ac 7c] [Jh]
mr.Lugaro: bets $0.15
Sumpfpumpf: raises $0.17 to $0.32
mr.Lugaro: folds
Uncalled bet ($0.17) returned to Sumpfpumpf
Sumpfpumpf collected $0.57 from pot
Sumpfpumpf: doesn't show hand
*** SUMMARY ***
Total pot $0.59 | Rake $0.02
Board [Kc 6h Ac 7c Jh]
Seat 1: Sumpfpumpf (button) collected ($0.57)
Seat 2: JFray756 (small blind) folded before Flop
Seat 3: mr.Lugaro (big blind) folded on the River
Seat 4: LavrikSanta folded before Flop (didn't bet)
Seat 5: HumptyD folded before Flop (didn't bet)
Seat 6: Probe_BeTT folded before Flop (didn't bet)

PokerStars Zoom Hand #251193750070:  Hold'em No Limit ($0.01/$0.02) - 2024/06/25 18:01:41 ET
Table 'Halley' 6-max Seat #1 is the button
Seat 1: DonRazVan18 ($2.53 in chips)
Seat 2: HumptyD ($2.31 in chips)
Seat 3: DONITA60 ($3.73 in chips)
Seat 4: MrRooob9899 ($1.98 in chips)
Seat 5: pkbundesliga ($1.97 in chips)
Seat 6: JFray756 ($1.76 in chips)
HumptyD: posts small blind $0.01
DONITA60: posts big blind $0.02
*** HOLE CARDS ***
Dealt to HumptyD [Th Td]
MrRooob9899: folds
pkbundesliga: folds
JFray756: raises $0.04 to $0.06
DonRazVan18: folds
HumptyD: raises $0.14 to $0.20
DONITA60: folds
JFray756: calls $0.14
*** FLOP *** [Ac 7d Qh]
HumptyD: bets $0.10
JFray756: calls $0.10
*** TURN *** [Ac 7d Qh] [3d]
HumptyD: checks
JFray756: bets $0.22
HumptyD: calls $0.22
*** RIVER *** [Ac 7d Qh 3d] [Qd]
HumptyD: checks
JFray756: checks
*** SHOW DOWN ***
HumptyD: shows [Th Td] (two pair, Queens and Tens)
JFray756: shows [Js Jh] (two pair, Queens and Jacks)
JFray756 collected $1.02 from pot
*** SUMMARY ***
Total pot $1.06 | Rake $0.04
Board [Ac 7d Qh 3d Qd]
Seat 1: DonRazVan18 (button) folded before Flop (didn't bet)
Seat 2: HumptyD (small blind) showed [Th Td] and lost with two pair, Queens and Tens
Seat 3: DONITA60 (big blind) folded before Flop
Seat 4: MrRooob9899 folded before Flop (didn't bet)
Seat 5: pkbundesliga folded before Flop (didn't bet)
Seat 6: JFray756 showed [Js Jh] and won ($1.02) with two pair, Queens and Jacks

PokerStars Zoom Hand #251193760859:  Hold'em No Limit ($0.01/$0.02) - 2024/06/25 18:02:21 ET
Table 'Halley' 6-max Seat #1 is the button
Seat 1: tolkien1986 ($2.96 in chips)
Seat 2: jsonborn ($2.14 in chips)
Seat 3: AT1LL4ZOREdd ($2.92 in chips)
Seat 4: bootycheck ($2 in chips)
Seat 5: JFray756 ($2.26 in chips)
Seat 6: HumptyD ($2 in chips)
jsonborn: posts small blind $0.01
AT1LL4ZOREdd: posts big blind $0.02
*** HOLE CARDS ***
Dealt to HumptyD [Qh 2c]
bootycheck: folds
JFray756: folds
HumptyD: folds
tolkien1986: folds
jsonborn: folds
Uncalled bet ($0.01) returned to AT1LL4ZOREdd
AT1LL4ZOREdd collected $0.02 from pot
AT1LL4ZOREdd: doesn't show hand
*** SUMMARY ***
Total pot $0.02 | Rake $0
Seat 1: tolkien1986 (button) folded before Flop (didn't bet)
Seat 2: jsonborn (small blind) folded before Flop
Seat 3: AT1LL4ZOREdd (big blind) collected ($0.02)
Seat 4: bootycheck folded before Flop (didn't bet)
Seat 5: JFray756 folded before Flop (didn't bet)
Seat 6: HumptyD folded before Flop (didn't bet)

PokerStars Zoom Hand #251193762744:  Hold'em No Limit ($0.01/$0.02) - 2024/06/25 18:02:28 ET
Table 'Halley' 6-max Seat #1 is the button
Seat 1: HumptyD ($2 in chips)
Seat 2: Cowden Calling ($3.61 in chips)
Seat 3: Nomi Kopi ($2.62 in chips)
Seat 4: TSCardinals ($2.45 in chips)
Seat 5: AT1LL4ZOREdd ($6.89 in chips)
Seat 6: gilberto98 ($2.05 in chips)
Cowden Calling: posts small blind $0.01
Nomi Kopi: posts big blind $0.02
*** HOLE CARDS ***
Dealt to HumptyD [8d 6s]
TSCardinals: folds
AT1LL4ZOREdd: folds
gilberto98: folds
HumptyD: folds
Cowden Calling: raises $0.02 to $0.04
Nomi Kopi: folds
Uncalled bet ($0.02) returned to Cowden Calling
Cowden Calling collected $0.04 from pot
Cowden Calling: doesn't show hand
*** SUMMARY ***
Total pot $0.04 | Rake $0
Seat 1: HumptyD (button) folded before Flop (didn't bet)
Seat 2: Cowden Calling (small blind) collected ($0.04)
Seat 3: Nomi Kopi (big blind) folded before Flop
Seat 4: TSCardinals folded before Flop (didn't bet)
Seat 5: AT1LL4ZOREdd folded before Flop (didn't bet)
Seat 6: gilberto98 folded before Flop (didn't bet)


Hand ID: 12

PokerStars Zoom Hand #251195657845:  Hold'em No Limit ($0.01/$0.02) - 2024/06/25 20:29:22 ET
Table 'Halley' 6-max Seat #1 is the button
Seat 1: miducontra ($2.04 in chips)
Seat 2: Egor24 ($2 in chips)
Seat 3: HumptyD ($2 in chips)
Seat 4: FinatoD ($3.25 in chips)
Seat 5: poKr.mak ($3.65 in chips)
Seat 6: GarryKas ($1.01 in chips)
Egor24: posts small blind $0.01
HumptyD: posts big blind $0.02
*** HOLE CARDS ***
Dealt to HumptyD [9d 3c]
FinatoD: folds
poKr.mak: folds
GarryKas: folds
miducontra: raises $0.02 to $0.04
Egor24: folds
HumptyD: folds
Uncalled bet ($0.02) returned to miducontra
miducontra collected $0.05 from pot
miducontra: doesn't show hand
*** SUMMARY ***
Total pot $0.05 | Rake $0
Seat 1: miducontra (button) collected ($0.05)
Seat 2: Egor24 (small blind) folded before Flop
Seat 3: HumptyD (big blind) folded before Flop
Seat 4: FinatoD folded before Flop (didn't bet)
Seat 5: poKr.mak folded before Flop (didn't bet)
Seat 6: GarryKas folded before Flop (didn't bet)

PokerStars Zoom Hand #251195660347:  Hold'em No Limit ($0.01/$0.02) - 2024/06/25 20:29:36 ET
Table 'Halley' 6-max Seat #1 is the button
Seat 1: apbambirra ($2.01 in chips)
Seat 2: HumptyD ($2 in chips)
Seat 3: edfb17 ($2 in chips)
Seat 4: NotXolo ($2.21 in chips)
Seat 5: Károly58 ($1.69 in chips)
Seat 6: GarryKas ($1 in chips)
HumptyD: posts small blind $0.01
edfb17: posts big blind $0.02
*** HOLE CARDS ***
Dealt to HumptyD [As 4h]
NotXolo: folds
Károly58: calls $0.02
GarryKas: raises $0.06 to $0.08
apbambirra: folds
HumptyD: folds
edfb17: folds
Károly58: folds
Uncalled bet ($0.06) returned to GarryKas
GarryKas collected $0.07 from pot
GarryKas: doesn't show hand
*** SUMMARY ***
Total pot $0.07 | Rake $0
Seat 1: apbambirra (button) folded before Flop (didn't bet)
Seat 2: HumptyD (small blind) folded before Flop
Seat 3: edfb17 (big blind) folded before Flop
Seat 4: NotXolo folded before Flop (didn't bet)
Seat 5: Károly58 folded before Flop
Seat 6: GarryKas collected ($0.07)

PokerStars Zoom Hand #251195665691:  Hold'em No Limit ($0.01/$0.02) - 2024/06/25 20:30:05 ET
Table 'Halley' 6-max Seat #1 is the button
Seat 1: NotXolo ($2.21 in chips)
Seat 2: kolakwolf545 ($1.71 in chips)
Seat 3: priidikas1 ($2.27 in chips)
Seat 4: p777777 ($3.80 in chips)
Seat 5: HumptyD ($2 in chips)
Seat 6: damian196607 ($9.02 in chips)
kolakwolf545: posts small blind $0.01
priidikas1: posts big blind $0.02
*** HOLE CARDS ***
Dealt to HumptyD [9c 6s]
p777777: folds
HumptyD: folds
damian196607: folds
NotXolo: folds
kolakwolf545: calls $0.01
priidikas1: checks
*** FLOP *** [Kh Ks Ah]
kolakwolf545: bets $0.06
priidikas1: folds
Uncalled bet ($0.06) returned to kolakwolf545
kolakwolf545 collected $0.04 from pot
kolakwolf545: doesn't show hand
*** SUMMARY ***
Total pot $0.04 | Rake $0
Board [Kh Ks Ah]
Seat 1: NotXolo (button) folded before Flop (didn't bet)
Seat 2: kolakwolf545 (small blind) collected ($0.04)
Seat 3: priidikas1 (big blind) folded on the Flop
Seat 4: p777777 folded before Flop (didn't bet)
Seat 5: HumptyD folded before Flop (didn't bet)
Seat 6: damian196607 folded before Flop (didn't bet)

PokerStars Zoom Hand #251195664571:  Hold'em No Limit ($0.01/$0.02) - 2024/06/25 20:29:59 ET
Table 'Halley' 6-max Seat #1 is the button
Seat 1: HumptyD ($2 in chips)
Seat 2: capuuh ($3.38 in chips)
Seat 3: Anasstazzia ($0.97 in chips)
Seat 4: Old_Soldier_D ($1.80 in chips)
Seat 5: Akgül84 ($0.93 in chips)
Seat 6: enry7.ice ($2.03 in chips)
capuuh: posts small blind $0.01
Anasstazzia: posts big blind $0.02
*** HOLE CARDS ***
Dealt to HumptyD [Qc 2d]
Old_Soldier_D: folds
Akgül84: calls $0.02
enry7.ice: folds
HumptyD: folds
capuuh: folds
Anasstazzia: raises $0.05 to $0.07
Akgül84: calls $0.05
*** FLOP *** [3d 9c Js]
Anasstazzia: bets $0.07
Akgül84: calls $0.07
*** TURN *** [3d 9c Js] [8d]
Anasstazzia: checks
Akgül84: bets $0.14
Anasstazzia: folds
Uncalled bet ($0.14) returned to Akgül84
Akgül84 collected $0.28 from pot
Akgül84: doesn't show hand
*** SUMMARY ***
Total pot $0.29 | Rake $0.01
Board [3d 9c Js 8d]
Seat 1: HumptyD (button) folded before Flop (didn't bet)
Seat 2: capuuh (small blind) folded before Flop
Seat 3: Anasstazzia (big blind) folded on the Turn
Seat 4: Old_Soldier_D folded before Flop (didn't bet)
Seat 5: Akgül84 collected ($0.28)
Seat 6: enry7.ice folded before Flop (didn't bet)

PokerStars Zoom Hand #251195670017:  Hold'em No Limit ($0.01/$0.02) - 2024/06/25 20:30:29 ET
Table 'Halley' 6-max Seat #1 is the button
Seat 1: bethjennings ($2.36 in chips)
Seat 2: capuuh ($2.55 in chips)
Seat 3: HumptyD ($2 in chips)
Seat 4: GPBLG ($2.05 in chips)
Seat 5: yukon Ronald ($2.94 in chips)
Seat 6: Timmuse ($2.03 in chips)
capuuh: posts small blind $0.01
HumptyD: posts big blind $0.02
*** HOLE CARDS ***
Dealt to HumptyD [Td Ks]
GPBLG: folds
yukon Ronald: folds
Timmuse: folds
bethjennings: folds
capuuh: raises $0.04 to $0.06
HumptyD: calls $0.04
*** FLOP *** [4c Tc Th]
capuuh: bets $0.04
HumptyD: raises $0.08 to $0.12
capuuh: calls $0.08
*** TURN *** [4c Tc Th] [Js]
capuuh: checks
HumptyD: bets $0.26
capuuh: folds
Uncalled bet ($0.26) returned to HumptyD
HumptyD collected $0.35 from pot
HumptyD: doesn't show hand
*** SUMMARY ***
Total pot $0.36 | Rake $0.01
Board [4c Tc Th Js]
Seat 1: bethjennings (button) folded before Flop (didn't bet)
Seat 2: capuuh (small blind) folded on the Turn
Seat 3: HumptyD (big blind) collected ($0.35)
Seat 4: GPBLG folded before Flop (didn't bet)
Seat 5: yukon Ronald folded before Flop (didn't bet)
Seat 6: Timmuse folded before Flop (didn't bet)

PokerStars Zoom Hand #251195681005:  Hold'em No Limit ($0.01/$0.02) - 2024/06/25 20:31:29 ET
Table 'Halley' 6-max Seat #1 is the button
Seat 1: gntto ($4.37 in chips)
Seat 2: HumptyD ($2.17 in chips)
Seat 3: mc_colman ($2.28 in chips)
Seat 4: edfb17 ($2 in chips)
Seat 5: Haryel Hernande ($2.66 in chips)
Seat 6: bethjennings ($2.60 in chips)
HumptyD: posts small blind $0.01
mc_colman: posts big blind $0.02
*** HOLE CARDS ***
Dealt to HumptyD [2d 4h]
edfb17: folds
Haryel Hernande: folds
bethjennings: raises $0.04 to $0.06
gntto: folds
HumptyD: folds
mc_colman: folds
Uncalled bet ($0.04) returned to bethjennings
bethjennings collected $0.05 from pot
bethjennings: doesn't show hand
*** SUMMARY ***
Total pot $0.05 | Rake $0
Seat 1: gntto (button) folded before Flop (didn't bet)
Seat 2: HumptyD (small blind) folded before Flop
Seat 3: mc_colman (big blind) folded before Flop
Seat 4: edfb17 folded before Flop (didn't bet)
Seat 5: Haryel Hernande folded before Flop (didn't bet)
Seat 6: bethjennings collected ($0.05)

PokerStars Zoom Hand #251195681909:  Hold'em No Limit ($0.01/$0.02) - 2024/06/25 20:31:34 ET
Table 'Halley' 6-max Seat #1 is the button
Seat 1: HumptyD ($2.16 in chips)
Seat 2: edfb17 ($2 in chips)
Seat 3: Haryel Hernande ($2.66 in chips)
Seat 4: Thebuntu ($2.34 in chips)
Seat 5: FinatoD ($5.72 in chips)
Seat 6: high811 ($7.69 in chips)
edfb17: posts small blind $0.01
Haryel Hernande: posts big blind $0.02
*** HOLE CARDS ***
Dealt to HumptyD [8c 7c]
Thebuntu: raises $0.02 to $0.04
FinatoD: raises $0.04 to $0.08
high811: folds
HumptyD: calls $0.08
edfb17: folds
Haryel Hernande: folds
Thebuntu: calls $0.04
*** FLOP *** [Ac 8h 9h]
Thebuntu: checks
FinatoD: checks
HumptyD: checks
*** TURN *** [Ac 8h 9h] [8s]
Thebuntu: checks
FinatoD: checks
HumptyD: bets $0.20
Thebuntu: folds
FinatoD: folds
Uncalled bet ($0.20) returned to HumptyD
HumptyD collected $0.26 from pot
HumptyD: doesn't show hand
*** SUMMARY ***
Total pot $0.27 | Rake $0.01
Board [Ac 8h 9h 8s]
Seat 1: HumptyD (button) collected ($0.26)
Seat 2: edfb17 (small blind) folded before Flop
Seat 3: Haryel Hernande (big blind) folded before Flop
Seat 4: Thebuntu folded on the Turn
Seat 5: FinatoD folded on the Turn
Seat 6: high811 folded before Flop (didn't bet)

PokerStars Zoom Hand #251195690066:  Hold'em No Limit ($0.01/$0.02) - 2024/06/25 20:32:19 ET
Table 'Halley' 6-max Seat #1 is the button
Seat 1: momo-luvEsl ($2.14 in chips)
Seat 2: bethjennings ($2.33 in chips)
Seat 3: Osini2024 ($2.29 in chips)
Seat 4: gilberto98 ($3.63 in chips)
Seat 5: HumptyD ($2.34 in chips)
Seat 6: capuuh ($3.87 in chips)
bethjennings: posts small blind $0.01
Osini2024: posts big blind $0.02
*** HOLE CARDS ***
Dealt to HumptyD [Td 5s]
gilberto98: raises $0.04 to $0.06
HumptyD: folds
capuuh: folds
momo-luvEsl: folds
bethjennings: folds
Osini2024: calls $0.04
*** FLOP *** [Ks 7s 6s]
Osini2024: checks
gilberto98: bets $0.06
Osini2024: folds
Uncalled bet ($0.06) returned to gilberto98
gilberto98 collected $0.13 from pot
gilberto98: doesn't show hand
*** SUMMARY ***
Total pot $0.13 | Rake $0
Board [Ks 7s 6s]
Seat 1: momo-luvEsl (button) folded before Flop (didn't bet)
Seat 2: bethjennings (small blind) folded before Flop
Seat 3: Osini2024 (big blind) folded on the Flop
Seat 4: gilberto98 collected ($0.13)
Seat 5: HumptyD folded before Flop (didn't bet)
Seat 6: capuuh folded before Flop (didn't bet)

PokerStars Zoom Hand #251195690992:  Hold'em No Limit ($0.01/$0.02) - 2024/06/25 20:32:24 ET
Table 'Halley' 6-max Seat #1 is the button
Seat 1: bingoloto ($2.22 in chips)
Seat 2: GarryKas ($1 in chips)
Seat 3: gntto ($2.08 in chips)
Seat 4: mixmanpow261 ($0.94 in chips)
Seat 5: QuadPokerBR ($2.02 in chips)
Seat 6: HumptyD ($2.34 in chips)
GarryKas: posts small blind $0.01
gntto: posts big blind $0.02
*** HOLE CARDS ***
Dealt to HumptyD [Td Ad]
mixmanpow261: folds
QuadPokerBR: folds
HumptyD: raises $0.04 to $0.06
bingoloto: folds
GarryKas: folds
gntto: calls $0.04
*** FLOP *** [Qc Qd 7d]
gntto: bets $0.03
HumptyD: raises $0.07 to $0.10
gntto: folds
Uncalled bet ($0.07) returned to HumptyD
HumptyD collected $0.18 from pot
HumptyD: doesn't show hand
*** SUMMARY ***
Total pot $0.19 | Rake $0.01
Board [Qc Qd 7d]
Seat 1: bingoloto (button) folded before Flop (didn't bet)
Seat 2: GarryKas (small blind) folded before Flop
Seat 3: gntto (big blind) folded on the Flop
Seat 4: mixmanpow261 folded before Flop (didn't bet)
Seat 5: QuadPokerBR folded before Flop (didn't bet)
Seat 6: HumptyD collected ($0.18)

PokerStars Zoom Hand #251195700192:  Hold'em No Limit ($0.01/$0.02) - 2024/06/25 20:33:15 ET
Table 'Halley' 6-max Seat #1 is the button
Seat 1: VRYAND16 ($1.74 in chips)
Seat 2: gilberto98 ($3.68 in chips)
Seat 3: Dehays777 ($1 in chips)
Seat 4: 0zym4nd14s ($2.38 in chips)
Seat 5: edfb17 ($2.05 in chips)
Seat 6: HumptyD ($2.43 in chips)
gilberto98: posts small blind $0.01
Dehays777: posts big blind $0.02
*** HOLE CARDS ***
Dealt to HumptyD [2s 5s]
0zym4nd14s: folds
edfb17: raises $0.03 to $0.05
HumptyD: folds
VRYAND16: folds
gilberto98: folds
Dehays777: folds
Uncalled bet ($0.03) returned to edfb17
edfb17 collected $0.05 from pot
edfb17: doesn't show hand
*** SUMMARY ***
Total pot $0.05 | Rake $0
Seat 1: VRYAND16 (button) folded before Flop (didn't bet)
Seat 2: gilberto98 (small blind) folded before Flop
Seat 3: Dehays777 (big blind) folded before Flop
Seat 4: 0zym4nd14s folded before Flop (didn't bet)
Seat 5: edfb17 collected ($0.05)
Seat 6: HumptyD folded before Flop (didn't bet)


Hand ID: 13

PokerStars Zoom Hand #251195658360:  Hold'em No Limit ($0.01/$0.02) - 2024/06/25 20:29:25 ET
Table 'Halley' 6-max Seat #1 is the button
Seat 1: IanMacDaddy ($2 in chips)
Seat 2: VRYAND16 ($2.01 in chips)
Seat 3: HumptyD ($2 in chips)
Seat 4: JORDYLEON ($3.83 in chips)
Seat 5: Károly58 ($3.73 in chips)
Seat 6: mixmanpow261 ($2.22 in chips)
VRYAND16: posts small blind $0.01
HumptyD: posts big blind $0.02
*** HOLE CARDS ***
Dealt to HumptyD [4d 2s]
JORDYLEON: folds
Károly58: folds
mixmanpow261: folds
IanMacDaddy: folds
VRYAND16: folds
Uncalled bet ($0.01) returned to HumptyD
HumptyD collected $0.02 from pot
HumptyD: doesn't show hand
*** SUMMARY ***
Total pot $0.02 | Rake $0
Seat 1: IanMacDaddy (button) folded before Flop (didn't bet)
Seat 2: VRYAND16 (small blind) folded before Flop
Seat 3: HumptyD (big blind) collected ($0.02)
Seat 4: JORDYLEON folded before Flop (didn't bet)
Seat 5: Károly58 folded before Flop (didn't bet)
Seat 6: mixmanpow261 folded before Flop (didn't bet)

PokerStars Zoom Hand #251195660179:  Hold'em No Limit ($0.01/$0.02) - 2024/06/25 20:29:35 ET
Table 'Halley' 6-max Seat #1 is the button
Seat 1: pursenatcher ($2.49 in chips)
Seat 2: HumptyD ($2.01 in chips)
Seat 3: momo-luvEsl ($2 in chips)
Seat 4: soyfuetus VI ($2.04 in chips)
Seat 5: apbambirra ($2.83 in chips)
Seat 6: lenzipoker ($1.26 in chips)
HumptyD: posts small blind $0.01
momo-luvEsl: posts big blind $0.02
*** HOLE CARDS ***
Dealt to HumptyD [Tc 5s]
soyfuetus VI: folds
apbambirra: folds
lenzipoker: folds
pursenatcher: folds
HumptyD: folds
Uncalled bet ($0.01) returned to momo-luvEsl
momo-luvEsl collected $0.02 from pot
momo-luvEsl: doesn't show hand
*** SUMMARY ***
Total pot $0.02 | Rake $0
Seat 1: pursenatcher (button) folded before Flop (didn't bet)
Seat 2: HumptyD (small blind) folded before Flop
Seat 3: momo-luvEsl (big blind) collected ($0.02)
Seat 4: soyfuetus VI folded before Flop (didn't bet)
Seat 5: apbambirra folded before Flop (didn't bet)
Seat 6: lenzipoker folded before Flop (didn't bet)

PokerStars Zoom Hand #251195661227:  Hold'em No Limit ($0.01/$0.02) - 2024/06/25 20:29:41 ET
Table 'Halley' 6-max Seat #1 is the button
Seat 1: HumptyD ($2 in chips)
Seat 2: FrancoGaston74 ($2.01 in chips)
Seat 3: Egor24 ($2.04 in chips)
Seat 4: Tenshi18 ($2.68 in chips)
Seat 5: Old_Soldier_D ($1.81 in chips)
Seat 6: estebangt01 ($1.34 in chips)
FrancoGaston74: posts small blind $0.01
Egor24: posts big blind $0.02
*** HOLE CARDS ***
Dealt to HumptyD [Js 7s]
Tenshi18: folds
Old_Soldier_D: folds
estebangt01: calls $0.02
HumptyD: calls $0.02
FrancoGaston74: folds
Egor24: checks
*** FLOP *** [8c Kc 2c]
Egor24: checks
estebangt01: checks
HumptyD: checks
*** TURN *** [8c Kc 2c] [8s]
Egor24: checks
estebangt01: bets $0.07
HumptyD: folds
Egor24: folds
Uncalled bet ($0.07) returned to estebangt01
estebangt01 collected $0.07 from pot
estebangt01: doesn't show hand
*** SUMMARY ***
Total pot $0.07 | Rake $0
Board [8c Kc 2c 8s]
Seat 1: HumptyD (button) folded on the Turn
Seat 2: FrancoGaston74 (small blind) folded before Flop
Seat 3: Egor24 (big blind) folded on the Turn
Seat 4: Tenshi18 folded before Flop (didn't bet)
Seat 5: Old_Soldier_D folded before Flop (didn't bet)
Seat 6: estebangt01 collected ($0.07)

PokerStars Zoom Hand #251195677362:  Hold'em No Limit ($0.01/$0.02) - 2024/06/25 20:31:09 ET
Table 'Halley' 6-max Seat #1 is the button
Seat 1: 0zym4nd14s ($2.45 in chips)
Seat 2: HumptyD ($2 in chips)
Seat 3: enry7.ice ($2.03 in chips)
Seat 4: chiefirif ($3.88 in chips)
Seat 5: comedeiro ($1.71 in chips)
Seat 6: apbambirra ($6.13 in chips)
HumptyD: posts small blind $0.01
enry7.ice: posts big blind $0.02
*** HOLE CARDS ***
Dealt to HumptyD [7c 8c]
chiefirif: folds
comedeiro: raises $0.02 to $0.04
apbambirra: folds
0zym4nd14s: folds
HumptyD: folds
enry7.ice: folds
Uncalled bet ($0.02) returned to comedeiro
comedeiro collected $0.05 from pot
comedeiro: doesn't show hand
*** SUMMARY ***
Total pot $0.05 | Rake $0
Seat 1: 0zym4nd14s (button) folded before Flop (didn't bet)
Seat 2: HumptyD (small blind) folded before Flop
Seat 3: enry7.ice (big blind) folded before Flop
Seat 4: chiefirif folded before Flop (didn't bet)
Seat 5: comedeiro collected ($0.05)
Seat 6: apbambirra folded before Flop (didn't bet)

PokerStars Zoom Hand #251195674438:  Hold'em No Limit ($0.01/$0.02) - 2024/06/25 20:30:53 ET
Table 'Halley' 6-max Seat #1 is the button
Seat 1: ghs10 ($1.17 in chips)
Seat 2: tebrothemeto ($2.04 in chips)
Seat 3: high811 ($6.59 in chips)
Seat 4: diegor00t ($3.24 in chips)
Seat 5: 42isthebet ($1.93 in chips)
Seat 6: HumptyD ($2 in chips)
tebrothemeto: posts small blind $0.01
high811: posts big blind $0.02
*** HOLE CARDS ***
Dealt to HumptyD [7c 5c]
diegor00t: folds
42isthebet: folds
HumptyD: folds
ghs10: raises $0.04 to $0.06
tebrothemeto: folds
high811: raises $0.22 to $0.28
ghs10: raises $0.89 to $1.17 and is all-in
high811: calls $0.89
*** FLOP *** [Jd Td 7h]
*** TURN *** [Jd Td 7h] [Js]
*** RIVER *** [Jd Td 7h Js] [9s]
*** SHOW DOWN ***
high811: shows [Kc As] (a pair of Jacks)
ghs10: shows [Ac Qd] (a pair of Jacks - lower kicker)
high811 collected $2.27 from pot
*** SUMMARY ***
Total pot $2.35 | Rake $0.08
Board [Jd Td 7h Js 9s]
Seat 1: ghs10 (button) showed [Ac Qd] and lost with a pair of Jacks
Seat 2: tebrothemeto (small blind) folded before Flop
Seat 3: high811 (big blind) showed [Kc As] and won ($2.27) with a pair of Jacks
Seat 4: diegor00t folded before Flop (didn't bet)
Seat 5: 42isthebet folded before Flop (didn't bet)
Seat 6: HumptyD folded before Flop (didn't bet)


Hand ID: 14


PokerStars Hand #248174866102: Tournament #3698663625, $0.92+$0.08 USD Hold'em No Limit - Level I (10/20) - 2024/01/09 18:37:51 ET
Table '3698663625 1' 3-max Seat #1 is the button
Seat 1: felipelomb (500 in chips)
Seat 2: HumptyD (500 in chips)
Seat 3: kastoria 1 (500 in chips)
HumptyD: posts small blind 10
kastoria 1: posts big blind 20
*** HOLE CARDS ***
Dealt to HumptyD [6d 3d]
felipelomb: raises 60 to 80
HumptyD: folds
kastoria 1: folds
Uncalled bet (60) returned to felipelomb
felipelomb collected 50 from pot
*** SUMMARY ***
Total pot 50 | Rake 0
Seat 1: felipelomb (button) collected (50)
Seat 2: HumptyD (small blind) folded before Flop
Seat 3: kastoria 1 (big blind) folded before Flop

PokerStars Hand #248174869883: Tournament #3698663625, $0.92+$0.08 USD Hold'em No Limit - Level I (10/20) - 2024/01/09 18:38:03 ET
Table '3698663625 1' 3-max Seat #2 is the button
Seat 1: felipelomb (530 in chips)
Seat 2: HumptyD (490 in chips)
Seat 3: kastoria 1 (480 in chips)
kastoria 1: posts small blind 10
felipelomb: posts big blind 20
*** HOLE CARDS ***
Dealt to HumptyD [6d 4s]
HumptyD: folds
kastoria 1: folds
Uncalled bet (10) returned to felipelomb
felipelomb collected 20 from pot
*** SUMMARY ***
Total pot 20 | Rake 0
Seat 1: felipelomb (big blind) collected (20)
Seat 2: HumptyD (button) folded before Flop (didn't bet)
Seat 3: kastoria 1 (small blind) folded before Flop

PokerStars Hand #248174871776: Tournament #3698663625, $0.92+$0.08 USD Hold'em No Limit - Level I (10/20) - 2024/01/09 18:38:09 ET
Table '3698663625 1' 3-max Seat #3 is the button
Seat 1: felipelomb (540 in chips)
Seat 2: HumptyD (490 in chips)
Seat 3: kastoria 1 (470 in chips)
felipelomb: posts small blind 10
HumptyD: posts big blind 20
*** HOLE CARDS ***
Dealt to HumptyD [5h 4h]
kastoria 1: raises 40 to 60
felipelomb: calls 50
HumptyD: folds
*** FLOP *** [2h 4d 5s]
felipelomb: bets 20
kastoria 1: raises 110 to 130
felipelomb: calls 110
*** TURN *** [2h 4d 5s] [2s]
felipelomb: checks
kastoria 1: bets 280 and is all-in
felipelomb: calls 280
*** RIVER *** [2h 4d 5s 2s] [As]
*** SHOW DOWN ***
felipelomb: shows [Ah 2c] (a full house, Deuces full of Aces)
kastoria 1: shows [Js Jd] (two pair, Jacks and Deuces)
felipelomb collected 960 from pot
kastoria 1 finished the tournament in 3rd place
*** SUMMARY ***
Total pot 960 | Rake 0
Board [2h 4d 5s 2s As]
Seat 1: felipelomb (small blind) showed [Ah 2c] and won (960) with a full house, Deuces full of Aces
Seat 2: HumptyD (big blind) folded before Flop
Seat 3: kastoria 1 (button) showed [Js Jd] and lost with two pair, Jacks and Deuces

PokerStars Hand #248174880798: Tournament #3698663625, $0.92+$0.08 USD Hold'em No Limit - Level I (10/20) - 2024/01/09 18:38:39 ET
Table '3698663625 1' 3-max Seat #2 is the button
Seat 1: felipelomb (1030 in chips)
Seat 2: HumptyD (470 in chips)
HumptyD: posts small blind 10
felipelomb: posts big blind 20
*** HOLE CARDS ***
Dealt to HumptyD [9d 2s]
HumptyD: folds
Uncalled bet (10) returned to felipelomb
felipelomb collected 20 from pot
*** SUMMARY ***
Total pot 20 | Rake 0
Seat 1: felipelomb (big blind) collected (20)
Seat 2: HumptyD (button) (small blind) folded before Flop

PokerStars Hand #248174881980: Tournament #3698663625, $0.92+$0.08 USD Hold'em No Limit - Level I (10/20) - 2024/01/09 18:38:43 ET
Table '3698663625 1' 3-max Seat #1 is the button
Seat 1: felipelomb (1040 in chips)
Seat 2: HumptyD (460 in chips)
felipelomb: posts small blind 10
HumptyD: posts big blind 20
*** HOLE CARDS ***
Dealt to HumptyD [3h Qc]
felipelomb: calls 10
HumptyD: checks
*** FLOP *** [9c 5d 6d]
HumptyD: checks
felipelomb: bets 40
HumptyD: folds
Uncalled bet (40) returned to felipelomb
felipelomb collected 40 from pot
*** SUMMARY ***
Total pot 40 | Rake 0
Board [9c 5d 6d]
Seat 1: felipelomb (button) (small blind) collected (40)
Seat 2: HumptyD (big blind) folded on the Flop

PokerStars Hand #248174890362: Tournament #3698663625, $0.92+$0.08 USD Hold'em No Limit - Level I (10/20) - 2024/01/09 18:39:10 ET
Table '3698663625 1' 3-max Seat #2 is the button
Seat 1: felipelomb (1060 in chips)
Seat 2: HumptyD (440 in chips)
HumptyD: posts small blind 10
felipelomb: posts big blind 20
*** HOLE CARDS ***
Dealt to HumptyD [4s Tc]
HumptyD: folds
Uncalled bet (10) returned to felipelomb
felipelomb collected 20 from pot
*** SUMMARY ***
Total pot 20 | Rake 0
Seat 1: felipelomb (big blind) collected (20)
Seat 2: HumptyD (button) (small blind) folded before Flop

PokerStars Hand #248174894621: Tournament #3698663625, $0.92+$0.08 USD Hold'em No Limit - Level I (10/20) - 2024/01/09 18:39:25 ET
Table '3698663625 1' 3-max Seat #1 is the button
Seat 1: felipelomb (1070 in chips)
Seat 2: HumptyD (430 in chips)
felipelomb: posts small blind 10
HumptyD: posts big blind 20
*** HOLE CARDS ***
Dealt to HumptyD [Kd 2d]
felipelomb: raises 20 to 40
HumptyD: calls 20
*** FLOP *** [Jc 8s Kh]
HumptyD: checks
felipelomb: bets 40
HumptyD: calls 40
*** TURN *** [Jc 8s Kh] [Ac]
HumptyD: checks
felipelomb: checks
*** RIVER *** [Jc 8s Kh Ac] [Ks]
HumptyD: bets 100
felipelomb: folds
Uncalled bet (100) returned to HumptyD
HumptyD collected 160 from pot
HumptyD: doesn't show hand
*** SUMMARY ***
Total pot 160 | Rake 0
Board [Jc 8s Kh Ac Ks]
Seat 1: felipelomb (button) (small blind) folded on the River
Seat 2: HumptyD (big blind) collected (160)

PokerStars Hand #248174907905: Tournament #3698663625, $0.92+$0.08 USD Hold'em No Limit - Level II (15/30) - 2024/01/09 18:40:07 ET
Table '3698663625 1' 3-max Seat #2 is the button
Seat 1: felipelomb (990 in chips)
Seat 2: HumptyD (510 in chips)
HumptyD: posts small blind 15
felipelomb: posts big blind 30
*** HOLE CARDS ***
Dealt to HumptyD [3s 8c]
HumptyD: folds
Uncalled bet (15) returned to felipelomb
felipelomb collected 30 from pot
*** SUMMARY ***
Total pot 30 | Rake 0
Seat 1: felipelomb (big blind) collected (30)
Seat 2: HumptyD (button) (small blind) folded before Flop

PokerStars Hand #248174909301: Tournament #3698663625, $0.92+$0.08 USD Hold'em No Limit - Level II (15/30) - 2024/01/09 18:40:12 ET
Table '3698663625 1' 3-max Seat #1 is the button
Seat 1: felipelomb (1005 in chips)
Seat 2: HumptyD (495 in chips)
felipelomb: posts small blind 15
HumptyD: posts big blind 30
*** HOLE CARDS ***
Dealt to HumptyD [4c Ks]
felipelomb: raises 30 to 60
HumptyD: calls 30
*** FLOP *** [Jh Jc Qh]
HumptyD: checks
felipelomb: bets 120
HumptyD: folds
Uncalled bet (120) returned to felipelomb
felipelomb collected 120 from pot
*** SUMMARY ***
Total pot 120 | Rake 0
Board [Jh Jc Qh]
Seat 1: felipelomb (button) (small blind) collected (120)
Seat 2: HumptyD (big blind) folded on the Flop

PokerStars Hand #248174917002: Tournament #3698663625, $0.92+$0.08 USD Hold'em No Limit - Level II (15/30) - 2024/01/09 18:40:37 ET
Table '3698663625 1' 3-max Seat #2 is the button
Seat 1: felipelomb (1065 in chips)
Seat 2: HumptyD (435 in chips)
HumptyD: posts small blind 15
felipelomb: posts big blind 30
*** HOLE CARDS ***
Dealt to HumptyD [6h 7s]
HumptyD: calls 15
felipelomb: checks
*** FLOP *** [8s Qd 8h]
felipelomb: checks
HumptyD: checks
*** TURN *** [8s Qd 8h] [5c]
felipelomb: checks
HumptyD: bets 60
felipelomb: folds
Uncalled bet (60) returned to HumptyD
HumptyD collected 60 from pot
HumptyD: doesn't show hand
*** SUMMARY ***
Total pot 60 | Rake 0
Board [8s Qd 8h 5c]
Seat 1: felipelomb (big blind) folded on the Turn
Seat 2: HumptyD (button) (small blind) collected (60)

PokerStars Hand #248174924272: Tournament #3698663625, $0.92+$0.08 USD Hold'em No Limit - Level II (15/30) - 2024/01/09 18:41:01 ET
Table '3698663625 1' 3-max Seat #1 is the button
Seat 1: felipelomb (1035 in chips)
Seat 2: HumptyD (465 in chips)
felipelomb: posts small blind 15
HumptyD: posts big blind 30
*** HOLE CARDS ***
Dealt to HumptyD [5d 7s]
felipelomb: calls 15
HumptyD: checks
*** FLOP *** [Qd 3h 5s]
HumptyD: checks
felipelomb: checks
*** TURN *** [Qd 3h 5s] [8c]
HumptyD: checks
felipelomb: checks
*** RIVER *** [Qd 3h 5s 8c] [Jd]
HumptyD: checks
felipelomb: bets 90
HumptyD: folds
Uncalled bet (90) returned to felipelomb
felipelomb collected 60 from pot
*** SUMMARY ***
Total pot 60 | Rake 0
Board [Qd 3h 5s 8c Jd]
Seat 1: felipelomb (button) (small blind) collected (60)
Seat 2: HumptyD (big blind) folded on the River

PokerStars Hand #248174930888: Tournament #3698663625, $0.92+$0.08 USD Hold'em No Limit - Level II (15/30) - 2024/01/09 18:41:23 ET
Table '3698663625 1' 3-max Seat #2 is the button
Seat 1: felipelomb (1065 in chips)
Seat 2: HumptyD (435 in chips)
HumptyD: posts small blind 15
felipelomb: posts big blind 30
*** HOLE CARDS ***
Dealt to HumptyD [Qd Kc]
HumptyD: calls 15
felipelomb: checks
*** FLOP *** [6s 3h Ts]
felipelomb: bets 30
HumptyD: folds
Uncalled bet (30) returned to felipelomb
felipelomb collected 60 from pot
*** SUMMARY ***
Total pot 60 | Rake 0
Board [6s 3h Ts]
Seat 1: felipelomb (big blind) collected (60)
Seat 2: HumptyD (button) (small blind) folded on the Flop

PokerStars Hand #248174935110: Tournament #3698663625, $0.92+$0.08 USD Hold'em No Limit - Level II (15/30) - 2024/01/09 18:41:37 ET
Table '3698663625 1' 3-max Seat #1 is the button
Seat 1: felipelomb (1095 in chips)
Seat 2: HumptyD (405 in chips)
felipelomb: posts small blind 15
HumptyD: posts big blind 30
*** HOLE CARDS ***
Dealt to HumptyD [2h Th]
felipelomb: calls 15
HumptyD: checks
*** FLOP *** [Kh Qs 7h]
HumptyD: checks
felipelomb: bets 60
HumptyD: calls 60
*** TURN *** [Kh Qs 7h] [3d]
HumptyD: checks
felipelomb: checks
*** RIVER *** [Kh Qs 7h 3d] [9d]
HumptyD: checks
felipelomb: bets 210
HumptyD: folds
Uncalled bet (210) returned to felipelomb
felipelomb collected 180 from pot
*** SUMMARY ***
Total pot 180 | Rake 0
Board [Kh Qs 7h 3d 9d]
Seat 1: felipelomb (button) (small blind) collected (180)
Seat 2: HumptyD (big blind) folded on the River

PokerStars Hand #248174944245: Tournament #3698663625, $0.92+$0.08 USD Hold'em No Limit - Level III (20/40) - 2024/01/09 18:42:07 ET
Table '3698663625 1' 3-max Seat #2 is the button
Seat 1: felipelomb (1185 in chips)
Seat 2: HumptyD (315 in chips)
HumptyD: posts small blind 20
felipelomb: posts big blind 40
*** HOLE CARDS ***
Dealt to HumptyD [3s 4h]
HumptyD: folds
Uncalled bet (20) returned to felipelomb
felipelomb collected 40 from pot
*** SUMMARY ***
Total pot 40 | Rake 0
Seat 1: felipelomb (big blind) collected (40)
Seat 2: HumptyD (button) (small blind) folded before Flop

PokerStars Hand #248174946728: Tournament #3698663625, $0.92+$0.08 USD Hold'em No Limit - Level III (20/40) - 2024/01/09 18:42:15 ET
Table '3698663625 1' 3-max Seat #1 is the button
Seat 1: felipelomb (1205 in chips)
Seat 2: HumptyD (295 in chips)
felipelomb: posts small blind 20
HumptyD: posts big blind 40
*** HOLE CARDS ***
Dealt to HumptyD [Tc Kh]
felipelomb: folds
Uncalled bet (20) returned to HumptyD
HumptyD collected 40 from pot
HumptyD: doesn't show hand
*** SUMMARY ***
Total pot 40 | Rake 0
Seat 1: felipelomb (button) (small blind) folded before Flop
Seat 2: HumptyD (big blind) collected (40)

PokerStars Hand #248174948079: Tournament #3698663625, $0.92+$0.08 USD Hold'em No Limit - Level III (20/40) - 2024/01/09 18:42:20 ET
Table '3698663625 1' 3-max Seat #2 is the button
Seat 1: felipelomb (1185 in chips)
Seat 2: HumptyD (315 in chips)
HumptyD: posts small blind 20
felipelomb: posts big blind 40
*** HOLE CARDS ***
Dealt to HumptyD [9d Kh]
HumptyD: raises 275 to 315 and is all-in
felipelomb: folds
Uncalled bet (275) returned to HumptyD
HumptyD collected 80 from pot
HumptyD: doesn't show hand
*** SUMMARY ***
Total pot 80 | Rake 0
Seat 1: felipelomb (big blind) folded before Flop
Seat 2: HumptyD (button) (small blind) collected (80)

PokerStars Hand #248174950248: Tournament #3698663625, $0.92+$0.08 USD Hold'em No Limit - Level III (20/40) - 2024/01/09 18:42:27 ET
Table '3698663625 1' 3-max Seat #1 is the button
Seat 1: felipelomb (1145 in chips)
Seat 2: HumptyD (355 in chips)
felipelomb: posts small blind 20
HumptyD: posts big blind 40
*** HOLE CARDS ***
Dealt to HumptyD [2c 5h]
felipelomb: raises 1105 to 1145 and is all-in
HumptyD: folds
Uncalled bet (1105) returned to felipelomb
felipelomb collected 80 from pot
*** SUMMARY ***
Total pot 80 | Rake 0
Seat 1: felipelomb (button) (small blind) collected (80)
Seat 2: HumptyD (big blind) folded before Flop

PokerStars Hand #248174952378: Tournament #3698663625, $0.92+$0.08 USD Hold'em No Limit - Level III (20/40) - 2024/01/09 18:42:34 ET
Table '3698663625 1' 3-max Seat #2 is the button
Seat 1: felipelomb (1185 in chips)
Seat 2: HumptyD (315 in chips)
HumptyD: posts small blind 20
felipelomb: posts big blind 40
*** HOLE CARDS ***
Dealt to HumptyD [9d Jd]
HumptyD: raises 275 to 315 and is all-in
felipelomb: folds
Uncalled bet (275) returned to HumptyD
HumptyD collected 80 from pot
HumptyD: doesn't show hand
*** SUMMARY ***
Total pot 80 | Rake 0
Seat 1: felipelomb (big blind) folded before Flop
Seat 2: HumptyD (button) (small blind) collected (80)

PokerStars Hand #248174954166: Tournament #3698663625, $0.92+$0.08 USD Hold'em No Limit - Level III (20/40) - 2024/01/09 18:42:40 ET
Table '3698663625 1' 3-max Seat #1 is the button
Seat 1: felipelomb (1145 in chips)
Seat 2: HumptyD (355 in chips)
felipelomb: posts small blind 20
HumptyD: posts big blind 40
*** HOLE CARDS ***
Dealt to HumptyD [Qc 2c]
felipelomb: raises 40 to 80
HumptyD: calls 40
*** FLOP *** [5h Ts Tc]
HumptyD: checks
felipelomb: checks
*** TURN *** [5h Ts Tc] [Qh]
HumptyD: checks
felipelomb: bets 80
HumptyD: calls 80
*** RIVER *** [5h Ts Tc Qh] [6d]
HumptyD: checks
felipelomb: checks
*** SHOW DOWN ***
HumptyD: shows [Qc 2c] (two pair, Queens and Tens)
felipelomb: mucks hand
HumptyD collected 320 from pot
*** SUMMARY ***
Total pot 320 | Rake 0
Board [5h Ts Tc Qh 6d]
Seat 1: felipelomb (button) (small blind) mucked [8h Jh]
Seat 2: HumptyD (big blind) showed [Qc 2c] and won (320) with two pair, Queens and Tens

PokerStars Hand #248174964158: Tournament #3698663625, $0.92+$0.08 USD Hold'em No Limit - Level III (20/40) - 2024/01/09 18:43:12 ET
Table '3698663625 1' 3-max Seat #2 is the button
Seat 1: felipelomb (985 in chips)
Seat 2: HumptyD (515 in chips)
HumptyD: posts small blind 20
felipelomb: posts big blind 40
*** HOLE CARDS ***
Dealt to HumptyD [8d 4c]
HumptyD: folds
Uncalled bet (20) returned to felipelomb
felipelomb collected 40 from pot
*** SUMMARY ***
Total pot 40 | Rake 0
Seat 1: felipelomb (big blind) collected (40)
Seat 2: HumptyD (button) (small blind) folded before Flop

PokerStars Hand #248174966158: Tournament #3698663625, $0.92+$0.08 USD Hold'em No Limit - Level III (20/40) - 2024/01/09 18:43:19 ET
Table '3698663625 1' 3-max Seat #1 is the button
Seat 1: felipelomb (1005 in chips)
Seat 2: HumptyD (495 in chips)
felipelomb: posts small blind 20
HumptyD: posts big blind 40
*** HOLE CARDS ***
Dealt to HumptyD [7h Kh]
felipelomb: raises 40 to 80
HumptyD: calls 40
*** FLOP *** [Js 5c 2d]
HumptyD: checks
felipelomb: bets 925 and is all-in
HumptyD: folds
Uncalled bet (925) returned to felipelomb
felipelomb collected 160 from pot
*** SUMMARY ***
Total pot 160 | Rake 0
Board [Js 5c 2d]
Seat 1: felipelomb (button) (small blind) collected (160)
Seat 2: HumptyD (big blind) folded on the Flop

PokerStars Hand #248174970932: Tournament #3698663625, $0.92+$0.08 USD Hold'em No Limit - Level III (20/40) - 2024/01/09 18:43:34 ET
Table '3698663625 1' 3-max Seat #2 is the button
Seat 1: felipelomb (1085 in chips)
Seat 2: HumptyD (415 in chips)
HumptyD: posts small blind 20
felipelomb: posts big blind 40
*** HOLE CARDS ***
Dealt to HumptyD [9c 4c]
HumptyD: folds
Uncalled bet (20) returned to felipelomb
felipelomb collected 40 from pot
*** SUMMARY ***
Total pot 40 | Rake 0
Seat 1: felipelomb (big blind) collected (40)
Seat 2: HumptyD (button) (small blind) folded before Flop

PokerStars Hand #248174972206: Tournament #3698663625, $0.92+$0.08 USD Hold'em No Limit - Level III (20/40) - 2024/01/09 18:43:39 ET
Table '3698663625 1' 3-max Seat #1 is the button
Seat 1: felipelomb (1105 in chips)
Seat 2: HumptyD (395 in chips)
felipelomb: posts small blind 20
HumptyD: posts big blind 40
*** HOLE CARDS ***
Dealt to HumptyD [8c 4c]
felipelomb: folds
Uncalled bet (20) returned to HumptyD
HumptyD collected 40 from pot
HumptyD: doesn't show hand
*** SUMMARY ***
Total pot 40 | Rake 0
Seat 1: felipelomb (button) (small blind) folded before Flop
Seat 2: HumptyD (big blind) collected (40)

PokerStars Hand #248174973618: Tournament #3698663625, $0.92+$0.08 USD Hold'em No Limit - Level III (20/40) - 2024/01/09 18:43:43 ET
Table '3698663625 1' 3-max Seat #2 is the button
Seat 1: felipelomb (1085 in chips)
Seat 2: HumptyD (415 in chips)
HumptyD: posts small blind 20
felipelomb: posts big blind 40
*** HOLE CARDS ***
Dealt to HumptyD [3s 5h]
HumptyD: folds
Uncalled bet (20) returned to felipelomb
felipelomb collected 40 from pot
*** SUMMARY ***
Total pot 40 | Rake 0
Seat 1: felipelomb (big blind) collected (40)
Seat 2: HumptyD (button) (small blind) folded before Flop

PokerStars Hand #248174974905: Tournament #3698663625, $0.92+$0.08 USD Hold'em No Limit - Level III (20/40) - 2024/01/09 18:43:48 ET
Table '3698663625 1' 3-max Seat #1 is the button
Seat 1: felipelomb (1105 in chips)
Seat 2: HumptyD (395 in chips)
felipelomb: posts small blind 20
HumptyD: posts big blind 40
*** HOLE CARDS ***
Dealt to HumptyD [Ad Td]
felipelomb: calls 20
HumptyD: raises 355 to 395 and is all-in
felipelomb: calls 355
*** FLOP *** [3d 5d Jd]
*** TURN *** [3d 5d Jd] [4d]
*** RIVER *** [3d 5d Jd 4d] [5h]
*** SHOW DOWN ***
HumptyD: shows [Ad Td] (a flush, Ace high)
felipelomb: shows [8h Qc] (a pair of Fives)
HumptyD collected 790 from pot
*** SUMMARY ***
Total pot 790 | Rake 0
Board [3d 5d Jd 4d 5h]
Seat 1: felipelomb (button) (small blind) showed [8h Qc] and lost with a pair of Fives
Seat 2: HumptyD (big blind) showed [Ad Td] and won (790) with a flush, Ace high

PokerStars Hand #248174980764: Tournament #3698663625, $0.92+$0.08 USD Hold'em No Limit - Level IV (30/60) - 2024/01/09 18:44:07 ET
Table '3698663625 1' 3-max Seat #2 is the button
Seat 1: felipelomb (710 in chips)
Seat 2: HumptyD (790 in chips)
HumptyD: posts small blind 30
felipelomb: posts big blind 60
*** HOLE CARDS ***
Dealt to HumptyD [Kh 4h]
HumptyD: calls 30
felipelomb: checks
*** FLOP *** [Qs 3d 7c]
felipelomb: bets 120
HumptyD: folds
Uncalled bet (120) returned to felipelomb
felipelomb collected 120 from pot
*** SUMMARY ***
Total pot 120 | Rake 0
Board [Qs 3d 7c]
Seat 1: felipelomb (big blind) collected (120)
Seat 2: HumptyD (button) (small blind) folded on the Flop

PokerStars Hand #248174984990: Tournament #3698663625, $0.92+$0.08 USD Hold'em No Limit - Level IV (30/60) - 2024/01/09 18:44:21 ET
Table '3698663625 1' 3-max Seat #1 is the button
Seat 1: felipelomb (770 in chips)
Seat 2: HumptyD (730 in chips)
felipelomb: posts small blind 30
HumptyD: posts big blind 60
*** HOLE CARDS ***
Dealt to HumptyD [7h Jh]
felipelomb: raises 120 to 180
HumptyD: folds
Uncalled bet (120) returned to felipelomb
felipelomb collected 120 from pot
*** SUMMARY ***
Total pot 120 | Rake 0
Seat 1: felipelomb (button) (small blind) collected (120)
Seat 2: HumptyD (big blind) folded before Flop

PokerStars Hand #248174987130: Tournament #3698663625, $0.92+$0.08 USD Hold'em No Limit - Level IV (30/60) - 2024/01/09 18:44:28 ET
Table '3698663625 1' 3-max Seat #2 is the button
Seat 1: felipelomb (830 in chips)
Seat 2: HumptyD (670 in chips)
HumptyD: posts small blind 30
felipelomb: posts big blind 60
*** HOLE CARDS ***
Dealt to HumptyD [5d Qd]
HumptyD: calls 30
felipelomb: checks
*** FLOP *** [9s Tc Td]
felipelomb: checks
HumptyD: checks
*** TURN *** [9s Tc Td] [7h]
felipelomb: checks
HumptyD: checks
*** RIVER *** [9s Tc Td 7h] [7s]
felipelomb: checks
HumptyD: checks
*** SHOW DOWN ***
felipelomb: shows [Jd 3s] (two pair, Tens and Sevens)
HumptyD: shows [5d Qd] (two pair, Tens and Sevens - Queen kicker)
HumptyD collected 120 from pot
*** SUMMARY ***
Total pot 120 | Rake 0
Board [9s Tc Td 7h 7s]
Seat 1: felipelomb (big blind) showed [Jd 3s] and lost with two pair, Tens and Sevens
Seat 2: HumptyD (button) (small blind) showed [5d Qd] and won (120) with two pair, Tens and Sevens

PokerStars Hand #248174991509: Tournament #3698663625, $0.92+$0.08 USD Hold'em No Limit - Level IV (30/60) - 2024/01/09 18:44:43 ET
Table '3698663625 1' 3-max Seat #1 is the button
Seat 1: felipelomb (770 in chips)
Seat 2: HumptyD (730 in chips)
felipelomb: posts small blind 30
HumptyD: posts big blind 60
*** HOLE CARDS ***
Dealt to HumptyD [Js 2d]
felipelomb: raises 60 to 120
HumptyD: folds
Uncalled bet (60) returned to felipelomb
felipelomb collected 120 from pot
*** SUMMARY ***
Total pot 120 | Rake 0
Seat 1: felipelomb (button) (small blind) collected (120)
Seat 2: HumptyD (big blind) folded before Flop

PokerStars Hand #248174993639: Tournament #3698663625, $0.92+$0.08 USD Hold'em No Limit - Level IV (30/60) - 2024/01/09 18:44:50 ET
Table '3698663625 1' 3-max Seat #2 is the button
Seat 1: felipelomb (830 in chips)
Seat 2: HumptyD (670 in chips)
HumptyD: posts small blind 30
felipelomb: posts big blind 60
*** HOLE CARDS ***
Dealt to HumptyD [Qs 6s]
HumptyD: calls 30
felipelomb: checks
*** FLOP *** [4d Ah 7h]
felipelomb: bets 240
HumptyD: folds
Uncalled bet (240) returned to felipelomb
felipelomb collected 120 from pot
*** SUMMARY ***
Total pot 120 | Rake 0
Board [4d Ah 7h]
Seat 1: felipelomb (big blind) collected (120)
Seat 2: HumptyD (button) (small blind) folded on the Flop

PokerStars Hand #248174996626: Tournament #3698663625, $0.92+$0.08 USD Hold'em No Limit - Level IV (30/60) - 2024/01/09 18:45:00 ET
Table '3698663625 1' 3-max Seat #1 is the button
Seat 1: felipelomb (890 in chips)
Seat 2: HumptyD (610 in chips)
felipelomb: posts small blind 30
HumptyD: posts big blind 60
*** HOLE CARDS ***
Dealt to HumptyD [Kd 2d]
felipelomb: calls 30
HumptyD: raises 550 to 610 and is all-in
felipelomb: calls 550
*** FLOP *** [6s 8h 9d]
*** TURN *** [6s 8h 9d] [As]
*** RIVER *** [6s 8h 9d As] [Ts]
*** SHOW DOWN ***
HumptyD: shows [Kd 2d] (high card Ace)
felipelomb: shows [Ah 6h] (two pair, Aces and Sixes)
felipelomb collected 1220 from pot
HumptyD finished the tournament in 2nd place
felipelomb wins the tournament and receives $2.00 - congratulations!
*** SUMMARY ***
Total pot 1220 | Rake 0
Board [6s 8h 9d As Ts]
Seat 1: felipelomb (button) (small blind) showed [Ah 6h] and won (1220) with two pair, Aces and Sixes
Seat 2: HumptyD (big blind) showed [Kd 2d] and lost with high card Ace

Hand ID: 15
PokerStars Zoom Hand #250961217484:  Hold'em No Limit ($0.01/$0.02) - 2024/06/10 19:21:02 ET
Table 'Halley' 6-max Seat #1 is the button
Seat 1: pedro064 ($0.48 in chips)
Seat 2: HumptyD ($2 in chips)
Seat 3: bflorenciano ($2.31 in chips)
Seat 4: JMassensini ($2.25 in chips)
Seat 5: brunoafrao ($1.14 in chips)
Seat 6: Tio Jhonas ($1.07 in chips)
HumptyD: posts small blind $0.01
bflorenciano: posts big blind $0.02
*** HOLE CARDS ***
Dealt to HumptyD [5c Qh]
JMassensini: folds
brunoafrao: folds
Tio Jhonas: folds
pedro064: folds
HumptyD: calls $0.01
bflorenciano: raises $0.08 to $0.10
HumptyD: folds
Uncalled bet ($0.08) returned to bflorenciano
bflorenciano collected $0.04 from pot
bflorenciano: doesn't show hand
*** SUMMARY ***
Total pot $0.04 | Rake $0
Seat 1: pedro064 (button) folded before Flop (didn't bet)
Seat 2: HumptyD (small blind) folded before Flop
Seat 3: bflorenciano (big blind) collected ($0.04)
Seat 4: JMassensini folded before Flop (didn't bet)
Seat 5: brunoafrao folded before Flop (didn't bet)
Seat 6: Tio Jhonas folded before Flop (didn't bet)

Hand ID: 17
PokerStars Zoom Hand #250961224809:  Hold'em No Limit ($0.01/$0.02) - 2024/06/10 19:21:35 ET
Table 'Halley' 6-max Seat #1 is the button
Seat 1: HumptyD ($2 in chips)
Seat 2: Matzet1ka ($2 in chips)
Seat 3: gary01407 ($2.22 in chips)
Seat 4: slidepop ($2.83 in chips)
Seat 5: coolDadJimbo ($6.87 in chips)
Seat 6: maldobex ($1.81 in chips)
Matzet1ka: posts small blind $0.01
gary01407: posts big blind $0.02
*** HOLE CARDS ***
Dealt to HumptyD [6c 4d]
slidepop: folds
coolDadJimbo: folds
maldobex: raises $0.04 to $0.06
HumptyD: folds
Matzet1ka: folds
gary01407: folds
Uncalled bet ($0.04) returned to maldobex
maldobex collected $0.05 from pot
maldobex: doesn't show hand
*** SUMMARY ***
Total pot $0.05 | Rake $0
Seat 1: HumptyD (button) folded before Flop (didn't bet)
Seat 2: Matzet1ka (small blind) folded before Flop
Seat 3: gary01407 (big blind) folded before Flop
Seat 4: slidepop folded before Flop (didn't bet)
Seat 5: coolDadJimbo folded before Flop (didn't bet)
Seat 6: maldobex collected ($0.05)

Hand ID: 18
PokerStars Zoom Hand #250961226365:  Hold'em No Limit ($0.01/$0.02) - 2024/06/10 19:21:42 ET
Table 'Halley' 6-max Seat #1 is the button
Seat 1: ripbon ($2.13 in chips)
Seat 2: praznina ($3.57 in chips)
Seat 3: HumptyD ($2 in chips)
Seat 4: TamiSieche ($4.27 in chips)
Seat 5: Mirajit ($2 in chips)
Seat 6: lewisweight ($2.01 in chips)
praznina: posts small blind $0.01
HumptyD: posts big blind $0.02
*** HOLE CARDS ***
Dealt to HumptyD [3s 4s]
TamiSieche: raises $0.05 to $0.07
Mirajit: folds
lewisweight: raises $0.13 to $0.20
ripbon: folds
praznina: folds
HumptyD: folds
TamiSieche: folds
Uncalled bet ($0.13) returned to lewisweight
lewisweight collected $0.17 from pot
lewisweight: doesn't show hand
*** SUMMARY ***
Total pot $0.17 | Rake $0
Seat 1: ripbon (button) folded before Flop (didn't bet)
Seat 2: praznina (small blind) folded before Flop
Seat 3: HumptyD (big blind) folded before Flop
Seat 4: TamiSieche folded before Flop
Seat 5: Mirajit folded before Flop (didn't bet)
Seat 6: lewisweight collected ($0.17)

Hand ID: 37
PokerStars Zoom Hand #250961303966:  Hold'em No Limit ($0.01/$0.02) - 2024/06/10 19:27:31 ET
Table 'Halley' 6-max Seat #1 is the button
Seat 1: HumptyD ($2.01 in chips)
Seat 2: BradonTok ($2.85 in chips)
Seat 3: Zoom Zap ($3.52 in chips)
Seat 4: bord258 ($2.05 in chips)
Seat 5: mr_maxsize ($4.63 in chips)
Seat 6: bettanye ($2 in chips)
BradonTok: posts small blind $0.01
Zoom Zap: posts big blind $0.02
*** HOLE CARDS ***
Dealt to HumptyD [3c Ts]
bord258: folds
mr_maxsize: folds
bettanye: raises $0.03 to $0.05
HumptyD: folds
BradonTok: folds
Zoom Zap: folds
Uncalled bet ($0.03) returned to bettanye
bettanye collected $0.05 from pot
bettanye: doesn't show hand
*** SUMMARY ***
Total pot $0.05 | Rake $0
Seat 1: HumptyD (button) folded before Flop (didn't bet)
Seat 2: BradonTok (small blind) folded before Flop
Seat 3: Zoom Zap (big blind) folded before Flop
Seat 4: bord258 folded before Flop (didn't bet)
Seat 5: mr_maxsize folded before Flop (didn't bet)
Seat 6: bettanye collected ($0.05)

Hand ID: 19
PokerStars Zoom Hand #250961235286:  Hold'em No Limit ($0.01/$0.02) - 2024/06/10 19:22:22 ET
Table 'Halley' 6-max Seat #1 is the button
Seat 1: inthegreenz369 ($1.64 in chips)
Seat 2: aricast19 ($2.28 in chips)
Seat 3: Aleksis Audio ($2.30 in chips)
Seat 4: M4DM4X_FR ($2.12 in chips)
Seat 5: HumptyD ($2 in chips)
Seat 6: Invron11 ($2.01 in chips)
aricast19: posts small blind $0.01
Aleksis Audio: posts big blind $0.02
*** HOLE CARDS ***
Dealt to HumptyD [9d 7d]
M4DM4X_FR: folds
HumptyD: folds
Invron11: folds
inthegreenz369: raises $0.03 to $0.05
aricast19: folds
Aleksis Audio: folds
Uncalled bet ($0.03) returned to inthegreenz369
inthegreenz369 collected $0.05 from pot
inthegreenz369: doesn't show hand
*** SUMMARY ***
Total pot $0.05 | Rake $0
Seat 1: inthegreenz369 (button) collected ($0.05)
Seat 2: aricast19 (small blind) folded before Flop
Seat 3: Aleksis Audio (big blind) folded before Flop
Seat 4: M4DM4X_FR folded before Flop (didn't bet)
Seat 5: HumptyD folded before Flop (didn't bet)
Seat 6: Invron11 folded before Flop (didn't bet)

Hand ID: 20
PokerStars Zoom Hand #250961237340:  Hold'em No Limit ($0.01/$0.02) - 2024/06/10 19:22:31 ET
Table 'Halley' 6-max Seat #1 is the button
Seat 1: DYAR17 ($1.32 in chips)
Seat 2: HumptyD ($2 in chips)
Seat 3: Luciano V609 ($4.53 in chips)
Seat 4: argent55 ($3.39 in chips)
Seat 5: hibyz ($3.08 in chips)
Seat 6: mr_maxsize ($4.19 in chips)
HumptyD: posts small blind $0.01
Luciano V609: posts big blind $0.02
*** HOLE CARDS ***
Dealt to HumptyD [3s 5s]
argent55: folds
hibyz: folds
mr_maxsize: folds
DYAR17: folds
HumptyD: folds
Uncalled bet ($0.01) returned to Luciano V609
Luciano V609 collected $0.02 from pot
Luciano V609: doesn't show hand
*** SUMMARY ***
Total pot $0.02 | Rake $0
Seat 1: DYAR17 (button) folded before Flop (didn't bet)
Seat 2: HumptyD (small blind) folded before Flop
Seat 3: Luciano V609 (big blind) collected ($0.02)
Seat 4: argent55 folded before Flop (didn't bet)
Seat 5: hibyz folded before Flop (didn't bet)
Seat 6: mr_maxsize folded before Flop (didn't bet)

Hand ID: 21
PokerStars Zoom Hand #250961240896:  Hold'em No Limit ($0.01/$0.02) - 2024/06/10 19:22:47 ET
Table 'Halley' 6-max Seat #1 is the button
Seat 1: Karlrotte ($1.31 in chips)
Seat 2: HECTOR1500 ($2 in chips)
Seat 3: bord258 ($1.68 in chips)
Seat 4: HumptyD ($2 in chips)
Seat 5: bryld2 ($2.47 in chips)
Seat 6: WhiteDeath55 ($2 in chips)
HECTOR1500: posts small blind $0.01
bord258: posts big blind $0.02
*** HOLE CARDS ***
Dealt to HumptyD [8h 7s]
HumptyD: folds
bryld2: folds
WhiteDeath55: folds
Karlrotte: folds
HECTOR1500: raises $0.04 to $0.06
bord258: folds
Uncalled bet ($0.04) returned to HECTOR1500
HECTOR1500 collected $0.04 from pot
HECTOR1500: doesn't show hand
*** SUMMARY ***
Total pot $0.04 | Rake $0
Seat 1: Karlrotte (button) folded before Flop (didn't bet)
Seat 2: HECTOR1500 (small blind) collected ($0.04)
Seat 3: bord258 (big blind) folded before Flop
Seat 4: HumptyD folded before Flop (didn't bet)
Seat 5: bryld2 folded before Flop (didn't bet)
Seat 6: WhiteDeath55 folded before Flop (didn't bet)

Hand ID: 22
PokerStars Zoom Hand #250961231071:  Hold'em No Limit ($0.01/$0.02) - 2024/06/10 19:22:03 ET
Table 'Halley' 6-max Seat #1 is the button
Seat 1: 15Thousand ($1.12 in chips)
Seat 2: Snakeflight ($7.55 in chips)
Seat 3: ildivodeoro ($1.66 in chips)
Seat 4: Mirajit ($5.66 in chips)
Seat 5: gra44fun ($2.64 in chips)
Seat 6: HumptyD ($2 in chips)
Snakeflight: posts small blind $0.01
ildivodeoro: posts big blind $0.02
*** HOLE CARDS ***
Dealt to HumptyD [Tc Jh]
Mirajit: folds
gra44fun: folds
HumptyD: folds
15Thousand: calls $0.02
Snakeflight: calls $0.01
ildivodeoro: checks
*** FLOP *** [3d 5d 8d]
Snakeflight: bets $0.03
ildivodeoro: calls $0.03
15Thousand: folds
*** TURN *** [3d 5d 8d] [Qh]
Snakeflight: bets $0.12
ildivodeoro: folds
Uncalled bet ($0.12) returned to Snakeflight
Snakeflight collected $0.12 from pot
Snakeflight: doesn't show hand
*** SUMMARY ***
Total pot $0.12 | Rake $0
Board [3d 5d 8d Qh]
Seat 1: 15Thousand (button) folded on the Flop
Seat 2: Snakeflight (small blind) collected ($0.12)
Seat 3: ildivodeoro (big blind) folded on the Turn
Seat 4: Mirajit folded before Flop (didn't bet)
Seat 5: gra44fun folded before Flop (didn't bet)
Seat 6: HumptyD folded before Flop (didn't bet)

Hand ID: 23
PokerStars Zoom Hand #250961242940:  Hold'em No Limit ($0.01/$0.02) - 2024/06/10 19:22:56 ET
Table 'Halley' 6-max Seat #1 is the button
Seat 1: mr_maxsize ($4.19 in chips)
Seat 2: bettanye ($2.08 in chips)
Seat 3: Invron11 ($3.18 in chips)
Seat 4: HumptyD ($2 in chips)
Seat 5: praznina ($3.01 in chips)
Seat 6: Mirajit ($2 in chips)
bettanye: posts small blind $0.01
Invron11: posts big blind $0.02
*** HOLE CARDS ***
Dealt to HumptyD [6c Js]
HumptyD: folds
praznina: folds
Mirajit: folds
mr_maxsize: folds
bettanye: folds
Uncalled bet ($0.01) returned to Invron11
Invron11 collected $0.02 from pot
Invron11: doesn't show hand
*** SUMMARY ***
Total pot $0.02 | Rake $0
Seat 1: mr_maxsize (button) folded before Flop (didn't bet)
Seat 2: bettanye (small blind) folded before Flop
Seat 3: Invron11 (big blind) collected ($0.02)
Seat 4: HumptyD folded before Flop (didn't bet)
Seat 5: praznina folded before Flop (didn't bet)
Seat 6: Mirajit folded before Flop (didn't bet)

Hand ID: 24
PokerStars Zoom Hand #250961241824:  Hold'em No Limit ($0.01/$0.02) - 2024/06/10 19:22:51 ET
Table 'Halley' 6-max Seat #1 is the button
Seat 1: HumptyD ($2 in chips)
Seat 2: Karlrotte ($1.31 in chips)
Seat 3: BaStEr001213 ($1.43 in chips)
Seat 4: schievelbein ($2.84 in chips)
Seat 5: RafaByPoker ($2.63 in chips)
Seat 6: AndreGlehn ($1.58 in chips)
Karlrotte: posts small blind $0.01
BaStEr001213: posts big blind $0.02
*** HOLE CARDS ***
Dealt to HumptyD [Qh 8h]
schievelbein: folds
RafaByPoker: folds
AndreGlehn: calls $0.02
HumptyD: folds
Karlrotte: calls $0.01
BaStEr001213: checks
*** FLOP *** [Qd Kh 3c]
Karlrotte: checks
BaStEr001213: checks
AndreGlehn: checks
*** TURN *** [Qd Kh 3c] [6c]
Karlrotte: checks
BaStEr001213: checks
AndreGlehn: bets $0.02
Karlrotte: calls $0.02
BaStEr001213: folds
*** RIVER *** [Qd Kh 3c 6c] [3d]
Karlrotte: bets $0.06
AndreGlehn: folds
Uncalled bet ($0.06) returned to Karlrotte
Karlrotte collected $0.10 from pot
Karlrotte: doesn't show hand
*** SUMMARY ***
Total pot $0.10 | Rake $0
Board [Qd Kh 3c 6c 3d]
Seat 1: HumptyD (button) folded before Flop (didn't bet)
Seat 2: Karlrotte (small blind) collected ($0.10)
Seat 3: BaStEr001213 (big blind) folded on the Turn
Seat 4: schievelbein folded before Flop (didn't bet)
Seat 5: RafaByPoker folded before Flop (didn't bet)
Seat 6: AndreGlehn folded on the River

Hand ID: 25
PokerStars Zoom Hand #250961246566:  Hold'em No Limit ($0.01/$0.02) - 2024/06/10 19:23:12 ET
Table 'Halley' 6-max Seat #1 is the button
Seat 1: brunoafrao ($1.11 in chips)
Seat 2: hibyz ($3.05 in chips)
Seat 3: Quantum771 ($2 in chips)
Seat 4: Shakalas248 ($4.20 in chips)
Seat 5: strashilisht ($2.24 in chips)
Seat 6: HumptyD ($2 in chips)
hibyz: posts small blind $0.01
Quantum771: posts big blind $0.02
*** HOLE CARDS ***
Dealt to HumptyD [2c Ac]
Shakalas248: folds
strashilisht: folds
HumptyD: raises $0.04 to $0.06
brunoafrao: folds
hibyz: calls $0.05
Quantum771: calls $0.04
*** FLOP *** [6d 4h 8h]
hibyz: bets $0.09
Quantum771: folds
HumptyD: folds
Uncalled bet ($0.09) returned to hibyz
hibyz collected $0.17 from pot
hibyz: doesn't show hand
*** SUMMARY ***
Total pot $0.18 | Rake $0.01
Board [6d 4h 8h]
Seat 1: brunoafrao (button) folded before Flop (didn't bet)
Seat 2: hibyz (small blind) collected ($0.17)
Seat 3: Quantum771 (big blind) folded on the Flop
Seat 4: Shakalas248 folded before Flop (didn't bet)
Seat 5: strashilisht folded before Flop (didn't bet)
Seat 6: HumptyD folded on the Flop

Hand ID: 26
PokerStars Zoom Hand #250961257541:  Hold'em No Limit ($0.01/$0.02) - 2024/06/10 19:24:01 ET
Table 'Halley' 6-max Seat #1 is the button
Seat 1: brunoafrao ($1.08 in chips)
Seat 2: -analisante- ($3.29 in chips)
Seat 3: HumptyD ($2 in chips)
Seat 4: ramirodl'b ($2.18 in chips)
Seat 5: mr_maxsize ($3.57 in chips)
Seat 6: Razhorus ($1.64 in chips)
-analisante-: posts small blind $0.01
HumptyD: posts big blind $0.02
*** HOLE CARDS ***
Dealt to HumptyD [9h 6c]
ramirodl'b: folds
mr_maxsize: raises $0.03 to $0.05
Razhorus: calls $0.05
brunoafrao: folds
-analisante-: folds
HumptyD: folds
*** FLOP *** [4c Qd 8s]
mr_maxsize: bets $0.10
Razhorus: folds
Uncalled bet ($0.10) returned to mr_maxsize
mr_maxsize collected $0.13 from pot
mr_maxsize: doesn't show hand
*** SUMMARY ***
Total pot $0.13 | Rake $0
Board [4c Qd 8s]
Seat 1: brunoafrao (button) folded before Flop (didn't bet)
Seat 2: -analisante- (small blind) folded before Flop
Seat 3: HumptyD (big blind) folded before Flop
Seat 4: ramirodl'b folded before Flop (didn't bet)
Seat 5: mr_maxsize collected ($0.13)
Seat 6: Razhorus folded on the Flop

Hand ID: 27
PokerStars Zoom Hand #250961259722:  Hold'em No Limit ($0.01/$0.02) - 2024/06/10 19:24:11 ET
Table 'Halley' 6-max Seat #1 is the button
Seat 1: HumptyD ($2 in chips)
Seat 2: gary01407 ($5.20 in chips)
Seat 3: maykolpb ($1.10 in chips)
Seat 4: bflorenciano ($3.36 in chips)
Seat 5: Quantum771 ($2.40 in chips)
Seat 6: alsec93 ($6.31 in chips)
gary01407: posts small blind $0.01
maykolpb: posts big blind $0.02
*** HOLE CARDS ***
Dealt to HumptyD [4s 3h]
bflorenciano: folds
Quantum771: folds
alsec93: raises $0.04 to $0.06
HumptyD: folds
gary01407: folds
maykolpb: folds
Uncalled bet ($0.04) returned to alsec93
alsec93 collected $0.05 from pot
alsec93: doesn't show hand
*** SUMMARY ***
Total pot $0.05 | Rake $0
Seat 1: HumptyD (button) folded before Flop (didn't bet)
Seat 2: gary01407 (small blind) folded before Flop
Seat 3: maykolpb (big blind) folded before Flop
Seat 4: bflorenciano folded before Flop (didn't bet)
Seat 5: Quantum771 folded before Flop (didn't bet)
Seat 6: alsec93 collected ($0.05)

Hand ID: 43
PokerStars Zoom Hand #250961322005:  Hold'em No Limit ($0.01/$0.02) - 2024/06/10 19:28:55 ET
Table 'Halley' 6-max Seat #1 is the button
Seat 1: brunoafrao ($1.28 in chips)
Seat 2: S@LTY"CTM" ($1.50 in chips)
Seat 3: WB_SOH ($2.38 in chips)
Seat 4: PR43Brazil ($3.31 in chips)
Seat 5: ARatherFitGuy ($1.62 in chips)
Seat 6: HumptyD ($2.03 in chips)
S@LTY"CTM": posts small blind $0.01
WB_SOH: posts big blind $0.02
*** HOLE CARDS ***
Dealt to HumptyD [Qc 9s]
PR43Brazil: folds
ARatherFitGuy: folds
HumptyD: folds
brunoafrao: folds
S@LTY"CTM": folds
Uncalled bet ($0.01) returned to WB_SOH
WB_SOH collected $0.02 from pot
WB_SOH: doesn't show hand
*** SUMMARY ***
Total pot $0.02 | Rake $0
Seat 1: brunoafrao (button) folded before Flop (didn't bet)
Seat 2: S@LTY"CTM" (small blind) folded before Flop
Seat 3: WB_SOH (big blind) collected ($0.02)
Seat 4: PR43Brazil folded before Flop (didn't bet)
Seat 5: ARatherFitGuy folded before Flop (didn't bet)
Seat 6: HumptyD folded before Flop (didn't bet)

Hand ID: 28
PokerStars Zoom Hand #250961261519:  Hold'em No Limit ($0.01/$0.02) - 2024/06/10 19:24:19 ET
Table 'Halley' 6-max Seat #1 is the button
Seat 1: kremator29 ($3.42 in chips)
Seat 2: xxcuentaxx70 ($1.09 in chips)
Seat 3: P.Escobarrrr ($2 in chips)
Seat 4: Matzet1ka ($2 in chips)
Seat 5: HumptyD ($2 in chips)
Seat 6: Sotosnc750x ($4.02 in chips)
xxcuentaxx70: posts small blind $0.01
P.Escobarrrr: posts big blind $0.02
*** HOLE CARDS ***
Dealt to HumptyD [2c 5s]
Matzet1ka: folds
HumptyD: folds
Sotosnc750x: calls $0.02
kremator29: folds
xxcuentaxx70: folds
P.Escobarrrr: checks
*** FLOP *** [Qd 3s Th]
P.Escobarrrr: checks
Sotosnc750x: checks
*** TURN *** [Qd 3s Th] [5c]
P.Escobarrrr: bets $0.03
Sotosnc750x: folds
Uncalled bet ($0.03) returned to P.Escobarrrr
P.Escobarrrr collected $0.05 from pot
P.Escobarrrr: doesn't show hand
*** SUMMARY ***
Total pot $0.05 | Rake $0
Board [Qd 3s Th 5c]
Seat 1: kremator29 (button) folded before Flop (didn't bet)
Seat 2: xxcuentaxx70 (small blind) folded before Flop
Seat 3: P.Escobarrrr (big blind) collected ($0.05)
Seat 4: Matzet1ka folded before Flop (didn't bet)
Seat 5: HumptyD folded before Flop (didn't bet)
Seat 6: Sotosnc750x folded on the Turn

Hand ID: 30
PokerStars Zoom Hand #250961282941:  Hold'em No Limit ($0.01/$0.02) - 2024/06/10 19:25:56 ET
Table 'Halley' 6-max Seat #1 is the button
Seat 1: praznina ($3.21 in chips)
Seat 2: Matzet1ka ($2.27 in chips)
Seat 3: gra44fun ($2.42 in chips)
Seat 4: Quantum771 ($2.59 in chips)
Seat 5: HumptyD ($2 in chips)
Seat 6: RafaByPoker ($2.58 in chips)
Matzet1ka: posts small blind $0.01
gra44fun: posts big blind $0.02
*** HOLE CARDS ***
Dealt to HumptyD [Qc 8c]
Quantum771: folds
HumptyD: raises $0.04 to $0.06
RafaByPoker: folds
praznina: folds
Matzet1ka: folds
gra44fun: folds
Uncalled bet ($0.04) returned to HumptyD
HumptyD collected $0.05 from pot
HumptyD: doesn't show hand
*** SUMMARY ***
Total pot $0.05 | Rake $0
Seat 1: praznina (button) folded before Flop (didn't bet)
Seat 2: Matzet1ka (small blind) folded before Flop
Seat 3: gra44fun (big blind) folded before Flop
Seat 4: Quantum771 folded before Flop (didn't bet)
Seat 5: HumptyD collected ($0.05)
Seat 6: RafaByPoker folded before Flop (didn't bet)

Hand ID: 31
PokerStars Zoom Hand #250961285371:  Hold'em No Limit ($0.01/$0.02) - 2024/06/10 19:26:07 ET
Table 'Halley' 6-max Seat #1 is the button
Seat 1: hibyz ($3.09 in chips)
Seat 2: S@LTY"CTM" ($1.70 in chips)
Seat 3: mr_maxsize ($3.59 in chips)
Seat 4: HumptyD ($2.03 in chips)
Seat 5: nicooIN ($1.36 in chips)
Seat 6: TAVINHOROOTS ($2.11 in chips)
S@LTY"CTM": posts small blind $0.01
mr_maxsize: posts big blind $0.02
*** HOLE CARDS ***
Dealt to HumptyD [9h 5d]
HumptyD: folds
nicooIN: folds
TAVINHOROOTS: folds
hibyz: folds
S@LTY"CTM": folds
Uncalled bet ($0.01) returned to mr_maxsize
mr_maxsize collected $0.02 from pot
mr_maxsize: doesn't show hand
*** SUMMARY ***
Total pot $0.02 | Rake $0
Seat 1: hibyz (button) folded before Flop (didn't bet)
Seat 2: S@LTY"CTM" (small blind) folded before Flop
Seat 3: mr_maxsize (big blind) collected ($0.02)
Seat 4: HumptyD folded before Flop (didn't bet)
Seat 5: nicooIN folded before Flop (didn't bet)
Seat 6: TAVINHOROOTS folded before Flop (didn't bet)

Hand ID: 53
PokerStars Zoom Hand #250961368078:  Hold'em No Limit ($0.01/$0.02) - 2024/06/10 19:32:28 ET
Table 'Halley' 6-max Seat #1 is the button
Seat 1: HumptyD ($2 in chips)
Seat 2: TSCardinals ($2 in chips)
Seat 3: mr_maxsize ($2.93 in chips)
Seat 4: viiv750 ($2 in chips)
Seat 5: coolDadJimbo ($6.69 in chips)
Seat 6: brunoafrao ($1.93 in chips)
TSCardinals: posts small blind $0.01
mr_maxsize: posts big blind $0.02
*** HOLE CARDS ***
Dealt to HumptyD [3h 6h]
viiv750: folds
coolDadJimbo: folds
brunoafrao: folds
HumptyD: folds
TSCardinals: folds
Uncalled bet ($0.01) returned to mr_maxsize
mr_maxsize collected $0.02 from pot
mr_maxsize: doesn't show hand
*** SUMMARY ***
Total pot $0.02 | Rake $0
Seat 1: HumptyD (button) folded before Flop (didn't bet)
Seat 2: TSCardinals (small blind) folded before Flop
Seat 3: mr_maxsize (big blind) collected ($0.02)
Seat 4: viiv750 folded before Flop (didn't bet)
Seat 5: coolDadJimbo folded before Flop (didn't bet)
Seat 6: brunoafrao folded before Flop (didn't bet)

Hand ID: 32
PokerStars Zoom Hand #250961288245:  Hold'em No Limit ($0.01/$0.02) - 2024/06/10 19:26:20 ET
Table 'Halley' 6-max Seat #1 is the button
Seat 1: R!usonken ($2.05 in chips)
Seat 2: HumptyD ($2.03 in chips)
Seat 3: praznina ($0.64 in chips)
Seat 4: TAVINHOROOTS ($2.11 in chips)
Seat 5: maykolpb ($1.14 in chips)
Seat 6: Amazonia2010 ($2.02 in chips)
HumptyD: posts small blind $0.01
praznina: posts big blind $0.02
*** HOLE CARDS ***
Dealt to HumptyD [9h Tc]
TAVINHOROOTS: folds
maykolpb: raises $0.04 to $0.06
Amazonia2010: folds
R!usonken: folds
HumptyD: folds
praznina: raises $0.10 to $0.16
maykolpb: raises $0.98 to $1.14 and is all-in
praznina: folds
Uncalled bet ($0.98) returned to maykolpb
maykolpb collected $0.33 from pot
maykolpb: doesn't show hand
*** SUMMARY ***
Total pot $0.33 | Rake $0
Seat 1: R!usonken (button) folded before Flop (didn't bet)
Seat 2: HumptyD (small blind) folded before Flop
Seat 3: praznina (big blind) folded before Flop
Seat 4: TAVINHOROOTS folded before Flop (didn't bet)
Seat 5: maykolpb collected ($0.33)
Seat 6: Amazonia2010 folded before Flop (didn't bet)

Hand ID: 33
PokerStars Zoom Hand #250961286921:  Hold'em No Limit ($0.01/$0.02) - 2024/06/10 19:26:14 ET
Table 'Halley' 6-max Seat #1 is the button
Seat 1: S@LTY"CTM" ($1.69 in chips)
Seat 2: matheus f 97 ($2.41 in chips)
Seat 3: Matzet1ka ($2 in chips)
Seat 4: thevillian74 ($1.02 in chips)
Seat 5: 15Thousand ($1.14 in chips)
Seat 6: HumptyD ($2.03 in chips)
matheus f 97: posts small blind $0.01
Matzet1ka: posts big blind $0.02
*** HOLE CARDS ***
Dealt to HumptyD [Kd 2h]
thevillian74: raises $0.02 to $0.04
15Thousand: folds
HumptyD: folds
S@LTY"CTM": calls $0.04
matheus f 97: calls $0.03
Matzet1ka: folds
*** FLOP *** [6d 7c 3c]
matheus f 97: checks
thevillian74: checks
S@LTY"CTM": checks
*** TURN *** [6d 7c 3c] [2s]
matheus f 97: checks
thevillian74: checks
S@LTY"CTM": checks
*** RIVER *** [6d 7c 3c 2s] [Jd]
matheus f 97: bets $0.07
thevillian74: folds
S@LTY"CTM": folds
Uncalled bet ($0.07) returned to matheus f 97
matheus f 97 collected $0.14 from pot
matheus f 97: doesn't show hand
*** SUMMARY ***
Total pot $0.14 | Rake $0
Board [6d 7c 3c 2s Jd]
Seat 1: S@LTY"CTM" (button) folded on the River
Seat 2: matheus f 97 (small blind) collected ($0.14)
Seat 3: Matzet1ka (big blind) folded before Flop
Seat 4: thevillian74 folded on the River
Seat 5: 15Thousand folded before Flop (didn't bet)
Seat 6: HumptyD folded before Flop (didn't bet)

Hand ID: 34
PokerStars Zoom Hand #250961293307:  Hold'em No Limit ($0.01/$0.02) - 2024/06/10 19:26:43 ET
Table 'Halley' 6-max Seat #1 is the button
Seat 1: HumptyD ($2 in chips)
Seat 2: Shakalas248 ($4.15 in chips)
Seat 3: Tio Jhonas ($0.92 in chips)
Seat 4: Crepaldi_119 ($1.07 in chips)
Seat 5: Keltu :D ($2.49 in chips)
Seat 6: Johnis111 ($1.98 in chips)
Shakalas248: posts small blind $0.01
Tio Jhonas: posts big blind $0.02
*** HOLE CARDS ***
Dealt to HumptyD [Js Ks]
Crepaldi_119: folds
Keltu :D: folds
Johnis111: folds
HumptyD: raises $0.04 to $0.06
Shakalas248: folds
Tio Jhonas: folds
Uncalled bet ($0.04) returned to HumptyD
HumptyD collected $0.05 from pot
HumptyD: doesn't show hand
*** SUMMARY ***
Total pot $0.05 | Rake $0
Seat 1: HumptyD (button) collected ($0.05)
Seat 2: Shakalas248 (small blind) folded before Flop
Seat 3: Tio Jhonas (big blind) folded before Flop
Seat 4: Crepaldi_119 folded before Flop (didn't bet)
Seat 5: Keltu :D folded before Flop (didn't bet)
Seat 6: Johnis111 folded before Flop (didn't bet)

Hand ID: 35
PokerStars Zoom Hand #250961290242:  Hold'em No Limit ($0.01/$0.02) - 2024/06/10 19:26:29 ET
Table 'Halley' 6-max Seat #1 is the button
Seat 1: PITUCAV ($2 in chips)
Seat 2: descandy ($2.07 in chips)
Seat 3: HumptyD ($2.02 in chips)
Seat 4: slidepop ($3.02 in chips)
Seat 5: Peebo-Nard ($6.98 in chips)
Seat 6: Freestyle_Bnet ($2 in chips)
descandy: posts small blind $0.01
HumptyD: posts big blind $0.02
*** HOLE CARDS ***
Dealt to HumptyD [7c Kd]
slidepop: folds
Peebo-Nard: folds
Freestyle_Bnet: raises $0.03 to $0.05
PITUCAV: folds
descandy: calls $0.04
HumptyD: folds
*** FLOP *** [2s 9s 6d]
descandy: checks
Freestyle_Bnet: checks
*** TURN *** [2s 9s 6d] [8c]
descandy: bets $0.07
Freestyle_Bnet: folds
Uncalled bet ($0.07) returned to descandy
descandy collected $0.12 from pot
descandy: doesn't show hand
*** SUMMARY ***
Total pot $0.12 | Rake $0
Board [2s 9s 6d 8c]
Seat 1: PITUCAV (button) folded before Flop (didn't bet)
Seat 2: descandy (small blind) collected ($0.12)
Seat 3: HumptyD (big blind) folded before Flop
Seat 4: slidepop folded before Flop (didn't bet)
Seat 5: Peebo-Nard folded before Flop (didn't bet)
Seat 6: Freestyle_Bnet folded on the Turn

Hand ID: 36
PokerStars Zoom Hand #250961299956:  Hold'em No Limit ($0.01/$0.02) - 2024/06/10 19:27:13 ET
Table 'Halley' 6-max Seat #1 is the button
Seat 1: BradonTok ($2.87 in chips)
Seat 2: TAVINHOROOTS ($2.03 in chips)
Seat 3: Poleza-51 ($1.86 in chips)
Seat 4: BeGoat ($1.45 in chips)
Seat 5: Mr_Supp31 ($1.43 in chips)
Seat 6: HumptyD ($2.03 in chips)
TAVINHOROOTS: posts small blind $0.01
Poleza-51: posts big blind $0.02
*** HOLE CARDS ***
Dealt to HumptyD [6h 2h]
BeGoat: folds
Mr_Supp31: folds
HumptyD: folds
BradonTok: folds
TAVINHOROOTS: folds
Uncalled bet ($0.01) returned to Poleza-51
Poleza-51 collected $0.02 from pot
Poleza-51: doesn't show hand
*** SUMMARY ***
Total pot $0.02 | Rake $0
Seat 1: BradonTok (button) folded before Flop (didn't bet)
Seat 2: TAVINHOROOTS (small blind) folded before Flop
Seat 3: Poleza-51 (big blind) collected ($0.02)
Seat 4: BeGoat folded before Flop (didn't bet)
Seat 5: Mr_Supp31 folded before Flop (didn't bet)
Seat 6: HumptyD folded before Flop (didn't bet)

Hand ID: 38
PokerStars Zoom Hand #250961298145:  Hold'em No Limit ($0.01/$0.02) - 2024/06/10 19:27:05 ET
Table 'Halley' 6-max Seat #1 is the button
Seat 1: pumpkidd ($2 in chips)
Seat 2: RafaByPoker ($2.16 in chips)
Seat 3: argent55 ($3.61 in chips)
Seat 4: Digulits ($4.70 in chips)
Seat 5: HumptyD ($2.03 in chips)
Seat 6: brenopmo ($2 in chips)
RafaByPoker: posts small blind $0.01
argent55: posts big blind $0.02
*** HOLE CARDS ***
Dealt to HumptyD [3c 7h]
Digulits: raises $0.02 to $0.04
HumptyD: folds
brenopmo: folds
pumpkidd: folds
RafaByPoker: calls $0.03
argent55: folds
*** FLOP *** [4c 6s Ah]
RafaByPoker: checks
Digulits: bets $0.05
RafaByPoker: folds
Uncalled bet ($0.05) returned to Digulits
Digulits collected $0.10 from pot
Digulits: doesn't show hand
*** SUMMARY ***
Total pot $0.10 | Rake $0
Board [4c 6s Ah]
Seat 1: pumpkidd (button) folded before Flop (didn't bet)
Seat 2: RafaByPoker (small blind) folded on the Flop
Seat 3: argent55 (big blind) folded before Flop
Seat 4: Digulits collected ($0.10)
Seat 5: HumptyD folded before Flop (didn't bet)
Seat 6: brenopmo folded before Flop (didn't bet)

Hand ID: 39
PokerStars Zoom Hand #250961305729:  Hold'em No Limit ($0.01/$0.02) - 2024/06/10 19:27:39 ET
Table 'Halley' 6-max Seat #1 is the button
Seat 1: Anuar Zhan star ($3.47 in chips)
Seat 2: HumptyD ($2.01 in chips)
Seat 3: Tio Jhonas ($0.89 in chips)
Seat 4: Rabbitsz ($3.97 in chips)
Seat 5: brenopmo ($2 in chips)
Seat 6: argent55 ($3.59 in chips)
HumptyD: posts small blind $0.01
Tio Jhonas: posts big blind $0.02
*** HOLE CARDS ***
Dealt to HumptyD [Tc 4d]
Rabbitsz: folds
brenopmo: folds
argent55: folds
Anuar Zhan star: folds
HumptyD: folds
Uncalled bet ($0.01) returned to Tio Jhonas
Tio Jhonas collected $0.02 from pot
Tio Jhonas: doesn't show hand
*** SUMMARY ***
Total pot $0.02 | Rake $0
Seat 1: Anuar Zhan star (button) folded before Flop (didn't bet)
Seat 2: HumptyD (small blind) folded before Flop
Seat 3: Tio Jhonas (big blind) collected ($0.02)
Seat 4: Rabbitsz folded before Flop (didn't bet)
Seat 5: brenopmo folded before Flop (didn't bet)
Seat 6: argent55 folded before Flop (didn't bet)

Hand ID: 40
PokerStars Zoom Hand #250961301056:  Hold'em No Limit ($0.01/$0.02) - 2024/06/10 19:27:18 ET
Table 'Halley' 6-max Seat #1 is the button
Seat 1: praznina ($3.13 in chips)
Seat 2: WB_SOH ($2.94 in chips)
Seat 3: HumptyD ($2.03 in chips)
Seat 4: ramirodl'b ($2.75 in chips)
Seat 5: invictusfp ($1.93 in chips)
Seat 6: Luciano V609 ($4.16 in chips)
WB_SOH: posts small blind $0.01
HumptyD: posts big blind $0.02
*** HOLE CARDS ***
Dealt to HumptyD [8h 9h]
ramirodl'b: folds
invictusfp: raises $0.03 to $0.05
Luciano V609: calls $0.05
praznina: raises $0.07 to $0.12
WB_SOH: raises $0.31 to $0.43
HumptyD: folds
invictusfp: folds
Luciano V609: folds
praznina: folds
Uncalled bet ($0.31) returned to WB_SOH
WB_SOH collected $0.36 from pot
WB_SOH: doesn't show hand
*** SUMMARY ***
Total pot $0.36 | Rake $0
Seat 1: praznina (button) folded before Flop
Seat 2: WB_SOH (small blind) collected ($0.36)
Seat 3: HumptyD (big blind) folded before Flop
Seat 4: ramirodl'b folded before Flop (didn't bet)
Seat 5: invictusfp folded before Flop
Seat 6: Luciano V609 folded before Flop

Hand ID: 41
PokerStars Zoom Hand #250961306601:  Hold'em No Limit ($0.01/$0.02) - 2024/06/10 19:27:43 ET
Table 'Halley' 6-max Seat #1 is the button
Seat 1: jackdanius ($2 in chips)
Seat 2: Rabbitsz ($3.97 in chips)
Seat 3: steel_gabriel ($2.95 in chips)
Seat 4: HumptyD ($2 in chips)
Seat 5: descandy ($2.12 in chips)
Seat 6: RafaByPoker ($2.12 in chips)
Rabbitsz: posts small blind $0.01
steel_gabriel: posts big blind $0.02
*** HOLE CARDS ***
Dealt to HumptyD [Ts Tc]
HumptyD: raises $0.04 to $0.06
steel_gabriel is disconnected
descandy: folds
RafaByPoker: folds
jackdanius: folds
Rabbitsz: folds
steel_gabriel has timed out while disconnected
steel_gabriel: folds
Uncalled bet ($0.04) returned to HumptyD
HumptyD collected $0.05 from pot
HumptyD: doesn't show hand
*** SUMMARY ***
Total pot $0.05 | Rake $0
Seat 1: jackdanius (button) folded before Flop (didn't bet)
Seat 2: Rabbitsz (small blind) folded before Flop
Seat 3: steel_gabriel (big blind) folded before Flop
Seat 4: HumptyD collected ($0.05)
Seat 5: descandy folded before Flop (didn't bet)
Seat 6: RafaByPoker folded before Flop (didn't bet)

Hand ID: 45
PokerStars Zoom Hand #250961327420:  Hold'em No Limit ($0.01/$0.02) - 2024/06/10 19:29:20 ET
Table 'Halley' 6-max Seat #1 is the button
Seat 1: Freestyle_Bnet ($2.12 in chips)
Seat 2: HumptyD ($2.01 in chips)
Seat 3: invictusfp ($3.86 in chips)
Seat 4: gary01407 ($9.01 in chips)
Seat 5: BradonTok ($2.44 in chips)
Seat 6: prwlgwolf77 ($2.06 in chips)
HumptyD: posts small blind $0.01
invictusfp: posts big blind $0.02
*** HOLE CARDS ***
Dealt to HumptyD [6s Ts]
gary01407: folds
BradonTok: folds
prwlgwolf77: raises $0.03 to $0.05
Freestyle_Bnet: raises $0.10 to $0.15
HumptyD: folds
invictusfp: folds
prwlgwolf77: folds
Uncalled bet ($0.10) returned to Freestyle_Bnet
Freestyle_Bnet collected $0.13 from pot
Freestyle_Bnet: doesn't show hand
*** SUMMARY ***
Total pot $0.13 | Rake $0
Seat 1: Freestyle_Bnet (button) collected ($0.13)
Seat 2: HumptyD (small blind) folded before Flop
Seat 3: invictusfp (big blind) folded before Flop
Seat 4: gary01407 folded before Flop (didn't bet)
Seat 5: BradonTok folded before Flop (didn't bet)
Seat 6: prwlgwolf77 folded before Flop

Hand ID: 46
PokerStars Zoom Hand #250961323715:  Hold'em No Limit ($0.01/$0.02) - 2024/06/10 19:29:03 ET
Table 'Halley' 6-max Seat #1 is the button
Seat 1: mr_maxsize ($5.01 in chips)
Seat 2: brunoafrao ($1.72 in chips)
Seat 3: HumptyD ($2.03 in chips)
Seat 4: FrancoOlmedo ($2.12 in chips)
Seat 5: teoortiz21 ($1.96 in chips)
Seat 6: maldobex ($2.30 in chips)
brunoafrao: posts small blind $0.01
HumptyD: posts big blind $0.02
*** HOLE CARDS ***
Dealt to HumptyD [Th Qc]
FrancoOlmedo: raises $0.04 to $0.06
teoortiz21: folds
maldobex: folds
mr_maxsize: folds
brunoafrao: calls $0.05
HumptyD: folds
*** FLOP *** [2c Tc Ts]
brunoafrao: checks
FrancoOlmedo: checks
*** TURN *** [2c Tc Ts] [5h]
brunoafrao: bets $0.09
FrancoOlmedo: folds
Uncalled bet ($0.09) returned to brunoafrao
brunoafrao collected $0.14 from pot
brunoafrao: doesn't show hand
*** SUMMARY ***
Total pot $0.14 | Rake $0
Board [2c Tc Ts 5h]
Seat 1: mr_maxsize (button) folded before Flop (didn't bet)
Seat 2: brunoafrao (small blind) collected ($0.14)
Seat 3: HumptyD (big blind) folded before Flop
Seat 4: FrancoOlmedo folded on the Turn
Seat 5: teoortiz21 folded before Flop (didn't bet)
Seat 6: maldobex folded before Flop (didn't bet)

Hand ID: 47
PokerStars Zoom Hand #250961329745:  Hold'em No Limit ($0.01/$0.02) - 2024/06/10 19:29:31 ET
Table 'Halley' 6-max Seat #1 is the button
Seat 1: HumptyD ($2 in chips)
Seat 2: capuuh ($2.06 in chips)
Seat 3: BaStEr001213 ($1.35 in chips)
Seat 4: bettanye ($2.12 in chips)
Seat 5: keky_144 ($1.60 in chips)
Seat 6: MacPoker19 ($2.29 in chips)
capuuh: posts small blind $0.01
BaStEr001213: posts big blind $0.02
*** HOLE CARDS ***
Dealt to HumptyD [9s Kh]
bettanye: raises $0.03 to $0.05
keky_144: folds
MacPoker19: folds
HumptyD: folds
capuuh: folds
BaStEr001213: raises $0.11 to $0.16
bettanye: folds
Uncalled bet ($0.11) returned to BaStEr001213
BaStEr001213 collected $0.11 from pot
BaStEr001213: doesn't show hand
*** SUMMARY ***
Total pot $0.11 | Rake $0
Seat 1: HumptyD (button) folded before Flop (didn't bet)
Seat 2: capuuh (small blind) folded before Flop
Seat 3: BaStEr001213 (big blind) collected ($0.11)
Seat 4: bettanye folded before Flop
Seat 5: keky_144 folded before Flop (didn't bet)
Seat 6: MacPoker19 folded before Flop (didn't bet)

Hand ID: 59
PokerStars Zoom Hand #250961400011:  Hold'em No Limit ($0.01/$0.02) - 2024/06/10 19:35:00 ET
Table 'Halley' 6-max Seat #1 is the button
Seat 1: Mirajit ($10.72 in chips)
Seat 2: WhiteDeath55 ($2.01 in chips)
Seat 3: HumptyD ($2 in chips)
Seat 4: invictusfp ($3.75 in chips)
Seat 5: PITUCAV ($2.09 in chips)
Seat 6: bettanye ($2 in chips)
WhiteDeath55: posts small blind $0.01
HumptyD: posts big blind $0.02
*** HOLE CARDS ***
Dealt to HumptyD [8c Ts]
invictusfp: folds
PITUCAV: folds
bettanye: folds
Mirajit: folds
WhiteDeath55: folds
Uncalled bet ($0.01) returned to HumptyD
HumptyD collected $0.02 from pot
HumptyD: doesn't show hand
*** SUMMARY ***
Total pot $0.02 | Rake $0
Seat 1: Mirajit (button) folded before Flop (didn't bet)
Seat 2: WhiteDeath55 (small blind) folded before Flop
Seat 3: HumptyD (big blind) collected ($0.02)
Seat 4: invictusfp folded before Flop (didn't bet)
Seat 5: PITUCAV folded before Flop (didn't bet)
Seat 6: bettanye folded before Flop (didn't bet)

Hand ID: 48
PokerStars Zoom Hand #250961326094:  Hold'em No Limit ($0.01/$0.02) - 2024/06/10 19:29:14 ET
Table 'Halley' 6-max Seat #1 is the button
Seat 1: ARatherFitGuy ($1.60 in chips)
Seat 2: shampu10p ($1.78 in chips)
Seat 3: 3 pair kid ($1.48 in chips)
Seat 4: HumptyD ($2.01 in chips)
Seat 5: bryld2 ($2.06 in chips)
Seat 6: JMassensini ($4.11 in chips)
shampu10p: posts small blind $0.01
3 pair kid: posts big blind $0.02
*** HOLE CARDS ***
Dealt to HumptyD [2h 8d]
HumptyD: folds
bryld2: raises $0.06 to $0.08
JMassensini: folds
ARatherFitGuy: calls $0.08
shampu10p: calls $0.07
3 pair kid: calls $0.06
*** FLOP *** [Qd 9c 5s]
shampu10p: checks
3 pair kid: checks
bryld2: checks
ARatherFitGuy: bets $0.31
shampu10p: folds
3 pair kid: folds
bryld2: folds
Uncalled bet ($0.31) returned to ARatherFitGuy
ARatherFitGuy collected $0.31 from pot
ARatherFitGuy: doesn't show hand
*** SUMMARY ***
Total pot $0.32 | Rake $0.01
Board [Qd 9c 5s]
Seat 1: ARatherFitGuy (button) collected ($0.31)
Seat 2: shampu10p (small blind) folded on the Flop
Seat 3: 3 pair kid (big blind) folded on the Flop
Seat 4: HumptyD folded before Flop (didn't bet)
Seat 5: bryld2 folded on the Flop
Seat 6: JMassensini folded before Flop (didn't bet)

Hand ID: 49
PokerStars Zoom Hand #250961331476:  Hold'em No Limit ($0.01/$0.02) - 2024/06/10 19:29:39 ET
Table 'Halley' 6-max Seat #1 is the button
Seat 1: S@LTY"CTM" ($1.47 in chips)
Seat 2: invictusfp ($3.84 in chips)
Seat 3: HumptyD ($2 in chips)
Seat 4: descandy ($2.12 in chips)
Seat 5: Johnis111 ($1.93 in chips)
Seat 6: pumpkidd ($2.62 in chips)
invictusfp: posts small blind $0.01
HumptyD: posts big blind $0.02
*** HOLE CARDS ***
Dealt to HumptyD [Ks 6d]
descandy: folds
Johnis111: folds
pumpkidd: raises $0.04 to $0.06
S@LTY"CTM": folds
invictusfp: folds
HumptyD: folds
Uncalled bet ($0.04) returned to pumpkidd
pumpkidd collected $0.05 from pot
pumpkidd: doesn't show hand
*** SUMMARY ***
Total pot $0.05 | Rake $0
Seat 1: S@LTY"CTM" (button) folded before Flop (didn't bet)
Seat 2: invictusfp (small blind) folded before Flop
Seat 3: HumptyD (big blind) folded before Flop
Seat 4: descandy folded before Flop (didn't bet)
Seat 5: Johnis111 folded before Flop (didn't bet)
Seat 6: pumpkidd collected ($0.05)

Hand ID: 50
PokerStars Zoom Hand #250961338942:  Hold'em No Limit ($0.01/$0.02) - 2024/06/10 19:30:13 ET
Table 'Halley' 6-max Seat #1 is the button
Seat 1: -analisante- ($2.79 in chips)
Seat 2: WB_SOH ($3.38 in chips)
Seat 3: bryld2 ($2 in chips)
Seat 4: TONY K995 ($2.43 in chips)
Seat 5: praznina ($1.96 in chips)
Seat 6: HumptyD ($2 in chips)
WB_SOH: posts small blind $0.01
bryld2: posts big blind $0.02
*** HOLE CARDS ***
Dealt to HumptyD [5c Ac]
TONY K995: folds
praznina: folds
HumptyD: raises $0.04 to $0.06
-analisante-: folds
WB_SOH: raises $0.17 to $0.23
bryld2: folds
HumptyD: calls $0.17
*** FLOP *** [3c Th Js]
WB_SOH: bets $0.27
HumptyD: folds
Uncalled bet ($0.27) returned to WB_SOH
WB_SOH collected $0.46 from pot
WB_SOH: doesn't show hand
*** SUMMARY ***
Total pot $0.48 | Rake $0.02
Board [3c Th Js]
Seat 1: -analisante- (button) folded before Flop (didn't bet)
Seat 2: WB_SOH (small blind) collected ($0.46)
Seat 3: bryld2 (big blind) folded before Flop
Seat 4: TONY K995 folded before Flop (didn't bet)
Seat 5: praznina folded before Flop (didn't bet)
Seat 6: HumptyD folded on the Flop

Hand ID: 51
PokerStars Zoom Hand #250961355568:  Hold'em No Limit ($0.01/$0.02) - 2024/06/10 19:31:30 ET
Table 'Halley' 6-max Seat #1 is the button
Seat 1: Invron11 ($3.13 in chips)
Seat 2: lewisweight ($3.37 in chips)
Seat 3: matheus f 97 ($2.45 in chips)
Seat 4: mr_maxsize ($5.22 in chips)
Seat 5: HumptyD ($2 in chips)
Seat 6: Johnis111 ($1.97 in chips)
lewisweight: posts small blind $0.01
matheus f 97: posts big blind $0.02
*** HOLE CARDS ***
Dealt to HumptyD [6c Qs]
mr_maxsize: folds
HumptyD: folds
Johnis111: folds
Invron11: folds
lewisweight: folds
Uncalled bet ($0.01) returned to matheus f 97
matheus f 97 collected $0.02 from pot
matheus f 97: doesn't show hand
*** SUMMARY ***
Total pot $0.02 | Rake $0
Seat 1: Invron11 (button) folded before Flop (didn't bet)
Seat 2: lewisweight (small blind) folded before Flop
Seat 3: matheus f 97 (big blind) collected ($0.02)
Seat 4: mr_maxsize folded before Flop (didn't bet)
Seat 5: HumptyD folded before Flop (didn't bet)
Seat 6: Johnis111 folded before Flop (didn't bet)

Hand ID: 54
PokerStars Zoom Hand #250961375259:  Hold'em No Limit ($0.01/$0.02) - 2024/06/10 19:33:03 ET
Table 'Halley' 6-max Seat #1 is the button
Seat 1: mr_maxsize ($5.30 in chips)
Seat 2: capuuh ($2.03 in chips)
Seat 3: PITUCAV ($2.08 in chips)
Seat 4: HumptyD ($2 in chips)
Seat 5: Dorie Danko ($1.63 in chips)
Seat 6: Freestyle_Bnet ($2.77 in chips)
capuuh: posts small blind $0.01
PITUCAV: posts big blind $0.02
*** HOLE CARDS ***
Dealt to HumptyD [Ac Ah]
HumptyD: raises $0.04 to $0.06
Dorie Danko: folds
Freestyle_Bnet: folds
mr_maxsize: folds
capuuh: folds
PITUCAV: calls $0.04
*** FLOP *** [3d Qc 3c]
PITUCAV: checks
HumptyD: bets $0.03
PITUCAV: folds
Uncalled bet ($0.03) returned to HumptyD
HumptyD collected $0.13 from pot
HumptyD: doesn't show hand
*** SUMMARY ***
Total pot $0.13 | Rake $0
Board [3d Qc 3c]
Seat 1: mr_maxsize (button) folded before Flop (didn't bet)
Seat 2: capuuh (small blind) folded before Flop
Seat 3: PITUCAV (big blind) folded on the Flop
Seat 4: HumptyD collected ($0.13)
Seat 5: Dorie Danko folded before Flop (didn't bet)
Seat 6: Freestyle_Bnet folded before Flop (didn't bet)

Hand ID: 56
PokerStars Zoom Hand #250961382031:  Hold'em No Limit ($0.01/$0.02) - 2024/06/10 19:33:35 ET
Table 'Halley' 6-max Seat #1 is the button
Seat 1: Leviathan74 ($2 in chips)
Seat 2: L3DCO ($1.04 in chips)
Seat 3: pcs48 ($1.88 in chips)
Seat 4: MMTI ($1.22 in chips)
Seat 5: pitboss914 ($2.46 in chips)
Seat 6: HumptyD ($2.07 in chips)
L3DCO: posts small blind $0.01
pcs48: posts big blind $0.02
*** HOLE CARDS ***
Dealt to HumptyD [9s Qs]
MMTI: calls $0.02
pitboss914: folds
HumptyD: raises $0.07 to $0.09
Leviathan74: folds
L3DCO: folds
pcs48: folds
MMTI: calls $0.07
*** FLOP *** [4h 5s 2d]
MMTI: checks
HumptyD: checks
*** TURN *** [4h 5s 2d] [3s]
MMTI: bets $0.13
HumptyD: calls $0.13
*** RIVER *** [4h 5s 2d 3s] [4c]
MMTI: bets $1 and is all-in
HumptyD: folds
Uncalled bet ($1) returned to MMTI
MMTI collected $0.45 from pot
MMTI: doesn't show hand
*** SUMMARY ***
Total pot $0.47 | Rake $0.02
Board [4h 5s 2d 3s 4c]
Seat 1: Leviathan74 (button) folded before Flop (didn't bet)
Seat 2: L3DCO (small blind) folded before Flop
Seat 3: pcs48 (big blind) folded before Flop
Seat 4: MMTI collected ($0.45)
Seat 5: pitboss914 folded before Flop (didn't bet)
Seat 6: HumptyD folded on the River

Hand ID: 57
PokerStars Zoom Hand #250961392358:  Hold'em No Limit ($0.01/$0.02) - 2024/06/10 19:34:24 ET
Table 'Halley' 6-max Seat #1 is the button
Seat 1: gomita31 ($2.41 in chips)
Seat 2: RollinOlson13 ($2.68 in chips)
Seat 3: HumptyD ($2 in chips)
Seat 4: Freestyle_Bnet ($4.03 in chips)
Seat 5: jackdanius ($2 in chips)
Seat 6: small9991 ($1.77 in chips)
RollinOlson13: posts small blind $0.01
HumptyD: posts big blind $0.02
*** HOLE CARDS ***
Dealt to HumptyD [Jc Js]
Freestyle_Bnet: folds
jackdanius: folds
small9991: folds
gomita31: folds
RollinOlson13: folds
Uncalled bet ($0.01) returned to HumptyD
HumptyD collected $0.02 from pot
HumptyD: doesn't show hand
*** SUMMARY ***
Total pot $0.02 | Rake $0
Seat 1: gomita31 (button) folded before Flop (didn't bet)
Seat 2: RollinOlson13 (small blind) folded before Flop
Seat 3: HumptyD (big blind) collected ($0.02)
Seat 4: Freestyle_Bnet folded before Flop (didn't bet)
Seat 5: jackdanius folded before Flop (didn't bet)
Seat 6: small9991 folded before Flop (didn't bet)

